,시,구,동,행정동코드,인구,남자,여자,geometry
0,서울특별시,종로구,사직동,11110530,9700,4375,5325,"MULTIPOLYGON (((126.9768888427482 37.57565077944879, 126.9770344988775 37.56919453005455, 126.9759747282125 37.56933629942576, 126.9753747099125 37.56931556702156, 126.9743319356233 37.56926180051753, 126.9690483700185 37.56819441770833, 126.9685449360338 37.56842767961276, 126.9666499598212 37.56949165520658, 126.9662817502448 37.5697007347987, 126.9660973270804 37.5698565097237, 126.9657285292258 37.57018393611511, 126.9659269982213 37.5703188056862, 126.9660109401843 37.57154839557748, 126.963659220522 37.57517466066037, 126.9630860043451 37.57648592001554, 126.962840990512 37.57666158609274, 126.9628104104726 37.57944880965677, 126.9674243158433 37.57960153712449, 126.9674217630265 37.57926352144165, 126.9674300601846 37.57919257799861, 126.9674570900956 37.57897525058544, 126.9680660469963 37.57824678046787, 126.9689551169548 37.57793526234029, 126.9692128429691 37.57793529930939, 126.9694145388658 37.57812112414218, 126.9696644266947 37.57853113668221, 126.9696672191487 37.57873620513492, 126.9696687735331 37.57899287900988, 126.9696694991036 37.5791125267496, 126.9699045736163 37.57930175362873, 126.9713519754476 37.57951327793981, 126.9738192578445 37.57937214030263, 126.9739173633834 37.57848707304101, 126.9739396199809 37.57824042997809, 126.9743315383576 37.57574990629986, 126.975803789978 37.5756494688242, 126.9768888427482 37.57565077944879)))"
1,서울특별시,종로구,삼청동,11110540,3013,1443,1570,"MULTIPOLYGON (((126.982689386493 37.5950655194224, 126.98337258457 37.59435192551688, 126.983868097928 37.59385046812643, 126.9840115836973 37.59375538189762, 126.9842734961909 37.59358183735348, 126.9846787672401 37.59333123147103, 126.9852253598527 37.5930571567418, 126.9852868081408 37.59302635633529, 126.9853287258072 37.59300572621492, 126.9857592771792 37.59279401160435, 126.9864798407838 37.59250646566559, 126.9875262282025 37.5922468001901, 126.9887608091341 37.59210400307575, 126.9891094507173 37.59195341550093, 126.9894757920867 37.5917950211998, 126.9890750481001 37.59139446162827, 126.9878984958088 37.5905567152052, 126.9862100279695 37.58901596665142, 126.9860138742825 37.58820164992094, 126.9860108742373 37.58802024141448, 126.9859569642824 37.58741835961283, 126.9857901289593 37.58707512222899, 126.9853371000307 37.58614589012119, 126.9849743622865 37.58563328549674, 126.9844653323453 37.58537368995111, 126.9837142178162 37.5849704355389, 126.9829183865103 37.58345832694683, 126.9828493159274 37.58322799314752, 126.982836207167 37.58285406704333, 126.982842104011 37.58271776362089, 126.9828648198948 37.58260632265811, 126.9829917870471 37.58205705864079, 126.9840346953684 37.57843370671978, 126.984639624275 37.577342343203, 126.9855331638257 37.576674025462, 126.984948844183 37.57633588036589, 126.9843447886809 37.5760645251064, 126.9831466523919 37.57552636292861, 126.9798390360508 37.57594335383953, 126.9795924891094 37.57597727455634, 126.9796057912844 37.57660704191863, 126.979617516159 37.57716144799568, 126.9796895403428 37.57860955110071, 126.9797411252997 37.57913143187454, 126.980028224962 37.580086995769, 126.9803037016248 37.58098617361973, 126.9794179389037 37.58590023032471, 126.9789736688563 37.58717817828867, 126.9788795757727 37.58727127731592, 126.9765668118176 37.58929695337157, 126.9761502251726 37.58954522797433, 126.9756933435133 37.58968403424009, 126.9736396597634 37.59259411899388, 126.9735872635534 37.5932890232807, 126.9758511377569 37.59656422224408, 126.9810580876733 37.59506510110588, 126.982689386493 37.5950655194224)))"
2,서울특별시,종로구,부암동,11110550,10525,5002,5523,"MULTIPOLYGON (((126.9758511377569 37.59656422224408, 126.9735872635534 37.5932890232807, 126.9719375264941 37.5938857822259, 126.9715476019638 37.59370130879074, 126.9698444131133 37.59347509519625, 126.9689248439463 37.59336392580813, 126.9688718922761 37.59336491426392, 126.9687789832648 37.59336665034412, 126.9687072740213 37.59341836116727, 126.9686423528942 37.59346518297949, 126.9685305986841 37.59350459936501, 126.9684720131749 37.59352525660245, 126.9681386529497 37.59361163575197, 126.9680439243682 37.59359205532072, 126.9664337494751 37.59293244072924, 126.9646881457353 37.59112072592575, 126.9645745138506 37.59097261926832, 126.964111613838 37.58998139049233, 126.9641376052684 37.58963500891115, 126.9641420421186 37.58958033196943, 126.9642400217167 37.5893430475863, 126.9642372441088 37.58913797948431, 126.9641159099608 37.5889785669954, 126.9634224872304 37.58814167454556, 126.9631738830229 37.58786338117127, 126.9622330053535 37.58698592219034, 126.9620363967875 37.58686814731631, 126.9619771439963 37.58683265456152, 126.9617106679302 37.58667821129155, 126.9605059752543 37.58626372501299, 126.9596821465636 37.58604476197731, 126.9594692987896 37.58601224045006, 126.9593112702535 37.58606121583168, 126.9591791236673 37.58610217226465, 126.958865149454 37.58595764505004, 126.9580484269533 37.58521114524583, 126.957804671329 37.58498834135819, 126.9577538691774 37.584868680012, 126.9578953246189 37.58381141046542, 126.9568940006547 37.58542010468457, 126.9571722339032 37.5864676031894, 126.9574735302318 37.58760184035394, 126.9579290613135 37.58879364348915, 126.9575146001883 37.59267208033364, 126.9572501681026 37.59314470375023, 126.9567657600107 37.5940105098196, 126.9564987063107 37.59470677017237, 126.956329141603 37.5951498224761, 126.9563125845426 37.59547761011785, 126.956309289704 37.59554294220439, 126.9563034580664 37.59566236563108, 126.9566126544457 37.59653656214865, 126.9569540128279 37.59762350150384, 126.9569833922861 37.59771780881644, 126.9570418857109 37.59790557493377, 126.9571456362435 37.59824292846682, 126.9571353789436 37.59838709587642, 126.957100419579 37.59845887110827, 126.9570548804556 37.59855234702035, 126.9569671211288 37.59861381582601, 126.9568833626137 37.59863292191683, 126.9567312084226 37.59866465188733, 126.9563510378744 37.5986606479587, 126.9562140547738 37.59859548988152, 126.9561238430308 37.5985525669517, 126.9561270983189 37.59851621283899, 126.9561323141599 37.59845796517131, 126.9555175721675 37.59848329764554, 126.9540932631613 37.59855107881121, 126.9539741538578 37.59866633211085, 126.9539356713675 37.5987035777452, 126.9538258579366 37.59881010385266, 126.9535085397932 37.59911847091431, 126.9527493088157 37.60040612359548, 126.9527627115309 37.60128120722582, 126.9527652458912 37.60144420027711, 126.9527771863469 37.60220668152909, 126.9527796388438 37.60225851907352, 126.9528019847456 37.60269470558269, 126.9528819566848 37.60278965850004, 126.9530121446462 37.602868930049, 126.9530814529544 37.60291113744483, 126.9532010847255 37.6030119658938, 126.9532648304203 37.60320266846133, 126.9535126620146 37.60426514533311, 126.9535364786087 37.60449397067246, 126.9535404349719 37.60457416229261, 126.9535426442699 37.60461905925903, 126.953437334822 37.60517402329219, 126.9533763212498 37.6053662840508, 126.9538575842548 37.60493035368017, 126.9540100545531 37.60480149063461, 126.9542380032758 37.60471241099108, 126.9546270514898 37.60457224932783, 126.9581544264826 37.60353167478217, 126.9582492303035 37.6035422509929, 126.9584235828031 37.60361741180495, 126.95862521702 37.60373776453215, 126.9587296584249 37.60380561788103, 126.9590944957997 37.60473815075263, 126.9600118783464 37.60585550704165, 126.9610705527937 37.60696894061422, 126.9615347874872 37.60705899444456, 126.9616380708158 37.60677892266332, 126.9616586978001 37.6067134631965, 126.961671405343 37.60667316816799, 126.9616960318471 37.60659666659296, 126.9617586581308 37.60645386449439, 126.9617733103506 37.60642370037181, 126.9618290959387 37.60630884463055, 126.9618894176468 37.60619194547464, 126.9619741460744 37.6060289638724, 126.962100387976 37.60580420428451, 126.9622284450716 37.60562226648509, 126.9626983832081 37.60506444928858, 126.9631591978859 37.60418517062339, 126.9632554840232 37.60400227591072, 126.9643317341468 37.60331200595572, 126.965664035225 37.6013700234922, 126.9661603032953 37.60088441844237, 126.9666112445109 37.60059802814503, 126.9671458641199 37.60029286042908, 126.9732954893539 37.59882077525424, 126.974103060069 37.59797156471124, 126.9741868934009 37.59760901381421, 126.9736751508933 37.59710436897586, 126.9738289453371 37.59702952225648, 126.9740055108748 37.5969436001788, 126.9758511377569 37.59656422224408)))"
3,서울특별시,종로구,평창동,11110560,18830,8817,10013,"MULTIPOLYGON (((126.9750746678809 37.63138628651299, 126.9764855443147 37.63008899733446, 126.9763545802853 37.629271579388, 126.9766720613351 37.6288448527654, 126.9782133569714 37.62843593611979, 126.9795240353134 37.62920222934059, 126.9800923123734 37.62927233505252, 126.980508194942 37.62905446496831, 126.9804968759252 37.62864543417669, 126.9801329740683 37.6283510868893, 126.9796664572043 37.62797478525102, 126.9794835037773 37.62716032283384, 126.9794377030683 37.62695639142638, 126.9792086885588 37.62457121153248, 126.9801711110254 37.6235525673367, 126.9808700629808 37.62275225912288, 126.9813736137946 37.62173377522717, 126.9820844977698 37.61992295343913, 126.9818005329071 37.61930541628534, 126.982019193894 37.61871274006239, 126.9828058746508 37.6166936891581, 126.983243293835 37.61631929720404, 126.9839756453184 37.61610167384227, 126.9845404034313 37.61587165062719, 126.9853413218618 37.61554542739916, 126.9866970327305 37.61468379283731, 126.987068092777 37.61355197137193, 126.9869596606811 37.61057482215976, 126.9867716987864 37.61040105655533, 126.9862714844579 37.60993863667942, 126.9859989142313 37.60879838063664, 126.9859737283335 37.60837689415818, 126.9859576470348 37.60810754856134, 126.9859006036692 37.60713611432764, 126.9861944053272 37.60627838883232, 126.9865892817783 37.60512555693499, 126.9877411917167 37.60121553576545, 126.9863746854395 37.60007953917753, 126.9849085265396 37.59943882994709, 126.9828973735987 37.59939269279064, 126.9827239066743 37.59938871484209, 126.9826736950306 37.59937835556374, 126.9822275986892 37.59928401269243, 126.98156656448 37.59914365527767, 126.9815664510535 37.59803838498007, 126.981566847345 37.59716526193013, 126.9820114258903 37.59584331683295, 126.9821934238158 37.59563342662802, 126.9823501148414 37.59545290805665, 126.9826523154141 37.59510477354859, 126.982689386493 37.5950655194224, 126.9810580876733 37.59506510110588, 126.9758511377569 37.59656422224408, 126.9740055108748 37.5969436001788, 126.9738289453371 37.59702952225648, 126.9736751508933 37.59710436897586, 126.9741868934009 37.59760901381421, 126.974103060069 37.59797156471124, 126.9732954893539 37.59882077525424, 126.9671458641199 37.60029286042908, 126.9666112445109 37.60059802814503, 126.9661603032953 37.60088441844237, 126.965664035225 37.6013700234922, 126.9643317341468 37.60331200595572, 126.9632554840232 37.60400227591072, 126.9631591978859 37.60418517062339, 126.9626983832081 37.60506444928858, 126.9622284450716 37.60562226648509, 126.962100387976 37.60580420428451, 126.9619741460744 37.6060289638724, 126.9618894176468 37.60619194547464, 126.9618290959387 37.60630884463055, 126.9617733103506 37.60642370037181, 126.9617586581308 37.60645386449439, 126.9616960318471 37.60659666659296, 126.961671405343 37.60667316816799, 126.9616586978001 37.6067134631965, 126.9616380708158 37.60677892266332, 126.9615347874872 37.60705899444456, 126.9610705527937 37.60696894061422, 126.9600118783464 37.60585550704165, 126.9590944957997 37.60473815075263, 126.9587296584249 37.60380561788103, 126.95862521702 37.60373776453215, 126.9584235828031 37.60361741180495, 126.9582492303035 37.6035422509929, 126.9581544264826 37.60353167478217, 126.9546270514898 37.60457224932783, 126.9542380032758 37.60471241099108, 126.9540100545531 37.60480149063461, 126.9538575842548 37.60493035368017, 126.9533763212498 37.6053662840508, 126.9531212637721 37.6055973155072, 126.9507368785767 37.60832020359569, 126.9503770463146 37.6078785962168, 126.9499832328689 37.60970523279793, 126.950633816386 37.61096446042617, 126.9508466123509 37.61180036113672, 126.9509366778276 37.61235961031377, 126.9506921956554 37.61488672553985, 126.9503962440484 37.61612806862719, 126.9503316426087 37.61836196031351, 126.9512409857418 37.62279288595064, 126.9517163396734 37.62432855049023, 126.9521716017255 37.62482296632809, 126.9523509742518 37.62489477927635, 126.9531783556529 37.6251667633698, 126.9567529613507 37.62536579675913, 126.9574769848946 37.62617486919115, 126.9595422280759 37.62848258383033, 126.9623416153841 37.62885027553708, 126.9676293401856 37.62980938922137, 126.9683419758299 37.62998532567903, 126.9688193458448 37.63010318034924, 126.969251985821 37.63022341331835, 126.970203682826 37.63086089310856, 126.9717859078064 37.63228533903874, 126.9750746678809 37.63138628651299)))"
4,서울특별시,종로구,무악동,11110570,8745,4078,4667,"MULTIPOLYGON (((126.960673532739 37.58079784202972, 126.9628104104726 37.57944880965677, 126.962840990512 37.57666158609274, 126.9617838308504 37.57513908653102, 126.9606917293308 37.57322005562149, 126.9604145446111 37.5730298517207, 126.9595707378107 37.57296121845079, 126.9539239562055 37.57849071623524, 126.9535560166695 37.57887566580947, 126.9541617505335 37.57889874854087, 126.9548098422277 37.57892481797071, 126.954952872627 37.57893057107094, 126.9554551445703 37.57897006960425, 126.9555571096007 37.57908687190313, 126.9557464595567 37.57930378371988, 126.9557685512201 37.58002395123692, 126.9557693336816 37.5800494854105, 126.9557948399294 37.58072925682743, 126.9564576046438 37.58128325688558, 126.9570018884703 37.58158320532254, 126.9571248221667 37.58161531779484, 126.9582688263123 37.58169718780316, 126.9587770618443 37.58161817291028, 126.960673532739 37.58079784202972)))"
5,서울특별시,종로구,교남동,11110580,10779,5021,5758,"MULTIPOLYGON (((126.9690483700185 37.56819441770833, 126.9680102711992 37.5671825142215, 126.96792521742 37.567096953691, 126.9673356767295 37.56650376640693, 126.9672974662963 37.56646554636407, 126.9671930515086 37.56636085699477, 126.96713423029 37.56630119278387, 126.9671864699827 37.56625582764381, 126.9667735382637 37.56579436403002, 126.9658121875202 37.56666901462727, 126.9618982600831 37.57065058360018, 126.9595707378107 37.57296121845079, 126.9604145446111 37.5730298517207, 126.9606917293308 37.57322005562149, 126.9617838308504 37.57513908653102, 126.962840990512 37.57666158609274, 126.9630860043451 37.57648592001554, 126.963659220522 37.57517466066037, 126.9660109401843 37.57154839557748, 126.9659269982213 37.5703188056862, 126.9657285292258 37.57018393611511, 126.9660973270804 37.5698565097237, 126.9662817502448 37.5697007347987, 126.9666499598212 37.56949165520658, 126.9685449360338 37.56842767961276, 126.9690483700185 37.56819441770833)))"
6,서울특별시,종로구,가회동,11110600,4487,2090,2397,"MULTIPOLYGON (((126.9891359030894 37.59130668631862, 126.9883083676072 37.58746911903312, 126.9880308550737 37.58554745777863, 126.9888590964895 37.58549532615424, 126.9893867101198 37.58369942750756, 126.9897723578014 37.58232091100437, 126.9897738829756 37.58225342940237, 126.9893002362791 37.57738738356293, 126.9889655756444 37.57737466933165, 126.9882401215526 37.57736701979388, 126.9855331638257 37.576674025462, 126.984639624275 37.577342343203, 126.9840346953684 37.57843370671978, 126.9829917870471 37.58205705864079, 126.9828648198948 37.58260632265811, 126.982842104011 37.58271776362089, 126.982836207167 37.58285406704333, 126.9828493159274 37.58322799314752, 126.9829183865103 37.58345832694683, 126.9837142178162 37.5849704355389, 126.9844653323453 37.58537368995111, 126.9849743622865 37.58563328549674, 126.9853371000307 37.58614589012119, 126.9857901289593 37.58707512222899, 126.9859569642824 37.58741835961283, 126.9860108742373 37.58802024141448, 126.9860138742825 37.58820164992094, 126.9862100279695 37.58901596665142, 126.9878984958088 37.5905567152052, 126.9890750481001 37.59139446162827, 126.9891359030894 37.59130668631862)))"
7,서울특별시,종로구,종로1.2.3.4가동,11110615,8630,4955,3675,"MULTIPOLYGON (((126.9964997845193 37.5810225677299, 126.9964117246961 37.58064588042269, 126.9966066390461 37.57934539433619, 126.9967579648929 37.5784221603199, 126.9971834726848 37.57693224535312, 126.9996776527815 37.57589728327856, 126.9993793519349 37.57583855688933, 126.9979692400431 37.57429921172459, 126.9979943203116 37.57403085957762, 126.9980561291264 37.57378124935038, 127.0004717112305 37.57075330633563, 127.0008320293041 37.57038820483153, 127.0008997394915 37.57031974086679, 127.0016222491592 37.56959157448218, 126.9983491068369 37.56895088287298, 126.9982973899722 37.56894091593279, 126.9979240697465 37.56888637378169, 126.9969766239248 37.56874939188403, 126.9967966683521 37.56872389200475, 126.9966966265454 37.56870989125176, 126.9908687824506 37.56824324248878, 126.9905920323297 37.56822401178576, 126.9895162417321 37.56814951948801, 126.9888983161631 37.5681085386568, 126.9868611882065 37.5682011032103, 126.986787299905 37.56820459472246, 126.9865992431933 37.56821348455564, 126.9857170061534 37.56837639374081, 126.984422328848 37.56861523785879, 126.9839702953816 37.56868762394625, 126.9827318096513 37.56888500509863, 126.9826921386665 37.56889046468609, 126.9778027177905 37.56924975808179, 126.9775840824726 37.56924090399486, 126.9770344988775 37.56919453005455, 126.9768888427482 37.57565077944879, 126.9795924891094 37.57597727455634, 126.9798390360508 37.57594335383953, 126.9831466523919 37.57552636292861, 126.9843447886809 37.5760645251064, 126.984948844183 37.57633588036589, 126.9855331638257 37.576674025462, 126.9882401215526 37.57736701979388, 126.9889655756444 37.57737466933165, 126.9893002362791 37.57738738356293, 126.9897738829756 37.58225342940237, 126.9897723578014 37.58232091100437, 126.9893867101198 37.58369942750756, 126.9888590964895 37.58549532615424, 126.9880308550737 37.58554745777863, 126.9883083676072 37.58746911903312, 126.9884303806787 37.58742234537463, 126.9892992556181 37.58727963952128, 126.9912991408195 37.58706519278284, 126.9922915706435 37.58719562326232, 126.9932892834612 37.58692953701408, 126.9958742834118 37.58350761039735, 126.9960279551438 37.58328743710543, 126.9962654637042 37.58270708341522, 126.9965420858462 37.58157369542727, 126.9964997845193 37.5810225677299)))"
8,서울특별시,종로구,종로5.6가동,11110630,5717,3142,2575,"MULTIPOLYGON (((127.0101604483956 37.57156810157083, 127.0095852321692 37.56978378493083, 127.0066836099916 37.5696477611322, 127.0016222491592 37.56959157448218, 127.0008997394915 37.57031974086679, 127.0008320293041 37.57038820483153, 127.0004717112305 37.57075330633563, 126.9980561291264 37.57378124935038, 126.9979943203116 37.57403085957762, 126.9979692400431 37.57429921172459, 126.9993793519349 37.57583855688933, 126.9996776527815 37.57589728327856, 127.0078330634183 37.57663511179821, 127.008613988002 37.57670881432088, 127.008557539439 37.57657566769911, 127.0085045495068 37.57642911259777, 127.0084331095824 37.57623151130525, 127.0084204352058 37.57615771036203, 127.0084044778301 37.57584944651766, 127.0088361317144 37.5727393428237, 127.0097269061034 37.57149242744257, 127.0101604483956 37.57156810157083)))"
9,서울특별시,종로구,이화동,11110640,8566,3939,4627,"MULTIPOLYGON (((127.0073325396313 37.58320333921623, 127.0088413178392 37.58045263873488, 127.008613988002 37.57670881432088, 127.0078330634183 37.57663511179821, 126.9996776527815 37.57589728327856, 126.9971834726848 37.57693224535312, 126.9967579648929 37.5784221603199, 126.9966066390461 37.57934539433619, 126.9964117246961 37.58064588042269, 126.9964997845193 37.5810225677299, 126.9982302630869 37.581266540341, 127.001804621914 37.58253031283793, 127.0017211283405 37.58313363545241, 127.0027208294721 37.58372368050578, 127.0058045952615 37.5847562782827, 127.0061821953815 37.5839612948596, 127.0073325396313 37.58320333921623)))"
10,서울특별시,종로구,창신1동,11110670,6098,3268,2830,"MULTIPOLYGON (((127.0157260408003 37.57298376265474, 127.0188185365185 37.57098451977708, 127.0175133756155 37.57029101296999, 127.0172783400352 37.5702024312381, 127.0171373467301 37.57014954041541, 127.0170003453341 37.5701027859073, 127.0168696861816 37.57005943724952, 127.0167409868101 37.57001950356381, 127.0166415466344 37.56998864893561, 127.0163801750635 37.56991209062485, 127.0161766627633 37.56986280930545, 127.016005640567 37.56982380100295, 127.0158654089304 37.56981531307181, 127.0157629720032 37.56980928655595, 127.0156654207759 37.56980859794676, 127.0153758582863 37.56980657136566, 127.0116157594745 37.56978206242719, 127.011285951644 37.56978182425201, 127.0101040119439 37.56978255882795, 127.0095852321692 37.56978378493083, 127.0101604483956 37.57156810157083, 127.0119608808745 37.57263839098752, 127.0126065575891 37.57467709134436, 127.012649293721 37.57538134668361, 127.0154776944663 37.57681045639643, 127.0156694701141 37.57557804700112, 127.0157260408003 37.57298376265474)))"
11,서울특별시,종로구,창신2동,11110680,9825,4996,4829,"MULTIPOLYGON (((127.0104800653117 37.58033548115759, 127.0111095046239 37.57891061096566, 127.0117318091938 37.57618210635931, 127.012649293721 37.57538134668361, 127.0126065575891 37.57467709134436, 127.0119608808745 37.57263839098752, 127.0101604483956 37.57156810157083, 127.0097269061034 37.57149242744257, 127.0088361317144 37.5727393428237, 127.0084044778301 37.57584944651766, 127.0084204352058 37.57615771036203, 127.0084331095824 37.57623151130525, 127.0085045495068 37.57642911259777, 127.008557539439 37.57657566769911, 127.008613988002 37.57670881432088, 127.0088413178392 37.58045263873488, 127.0099654330849 37.58020835714158, 127.0104800653117 37.58033548115759)))"
12,서울특별시,종로구,창신3동,11110690,7322,3606,3716,"MULTIPOLYGON (((127.0149504964771 37.58213073135636, 127.0149509615907 37.58141191900284, 127.0154776944663 37.57681045639643, 127.012649293721 37.57538134668361, 127.0117318091938 37.57618210635931, 127.0111095046239 37.57891061096566, 127.0104800653117 37.58033548115759, 127.0121550244591 37.58150517845035, 127.012801219237 37.58131747945706, 127.0131223864201 37.58143931902778, 127.0138277921009 37.58170812346521, 127.0146858848304 37.58222654740629, 127.0149504964771 37.58213073135636)))"
13,서울특별시,종로구,숭인1동,11110700,6613,3237,3376,"MULTIPOLYGON (((127.0187516636571 37.5775269002752, 127.0191137166765 37.57516121467827, 127.0191680508145 37.5747456897067, 127.0188751079565 37.57396370424468, 127.017638558308 37.57348757621025, 127.0175886968993 37.57347067230245, 127.0172121640845 37.57334302372096, 127.0165252760691 37.57317697499821, 127.0157260408003 37.57298376265474, 127.0156694701141 37.57557804700112, 127.0154776944663 37.57681045639643, 127.0149509615907 37.58141191900284, 127.0149504964771 37.58213073135636, 127.0160673028117 37.58184013347665, 127.0163900710065 37.5818425829683, 127.0167863320873 37.58153662148743, 127.0176045239479 37.57968880236296, 127.0180055103903 37.57805818233138, 127.0187516636571 37.5775269002752)))"
14,서울특별시,종로구,숭인2동,11110710,9972,5008,4964,"MULTIPOLYGON (((127.0231678778042 37.57804158355124, 127.0233681239995 37.5717398548992, 127.0188185365185 37.57098451977708, 127.0157260408003 37.57298376265474, 127.0165252760691 37.57317697499821, 127.0172121640845 37.57334302372096, 127.0175886968993 37.57347067230245, 127.017638558308 37.57348757621025, 127.0188751079565 37.57396370424468, 127.0191680508145 37.5747456897067, 127.0191137166765 37.57516121467827, 127.0187516636571 37.5775269002752, 127.0225087439379 37.57809642692493, 127.0231678778042 37.57804158355124)))"
15,서울특별시,종로구,청운효자동,11110515,13090,6120,6970,"MULTIPOLYGON (((126.9735872635534 37.5932890232807, 126.9736396597634 37.59259411899388, 126.9756933435133 37.58968403424009, 126.9761502251726 37.58954522797433, 126.9765668118176 37.58929695337157, 126.9788795757727 37.58727127731592, 126.9789736688563 37.58717817828867, 126.9794179389037 37.58590023032471, 126.9803037016248 37.58098617361973, 126.980028224962 37.580086995769, 126.9797411252997 37.57913143187454, 126.9796895403428 37.57860955110071, 126.979617516159 37.57716144799568, 126.9796057912844 37.57660704191863, 126.9795924891094 37.57597727455634, 126.9768888427482 37.57565077944879, 126.975803789978 37.5756494688242, 126.9743315383576 37.57574990629986, 126.9739396199809 37.57824042997809, 126.9739173633834 37.57848707304101, 126.9738192578445 37.57937214030263, 126.9713519754476 37.57951327793981, 126.9699045736163 37.57930175362873, 126.9696694991036 37.5791125267496, 126.9696687735331 37.57899287900988, 126.9696672191487 37.57873620513492, 126.9696644266947 37.57853113668221, 126.9694145388658 37.57812112414218, 126.9692128429691 37.57793529930939, 126.9689551169548 37.57793526234029, 126.9680660469963 37.57824678046787, 126.9674570900956 37.57897525058544, 126.9674300601846 37.57919257799861, 126.9674217630265 37.57926352144165, 126.9674243158433 37.57960153712449, 126.9628104104726 37.57944880965677, 126.960673532739 37.58079784202972, 126.9578953246189 37.58381141046542, 126.9577538691774 37.584868680012, 126.957804671329 37.58498834135819, 126.9580484269533 37.58521114524583, 126.958865149454 37.58595764505004, 126.9591791236673 37.58610217226465, 126.9593112702535 37.58606121583168, 126.9594692987896 37.58601224045006, 126.9596821465636 37.58604476197731, 126.9605059752543 37.58626372501299, 126.9617106679302 37.58667821129155, 126.9619771439963 37.58683265456152, 126.9620363967875 37.58686814731631, 126.9622330053535 37.58698592219034, 126.9631738830229 37.58786338117127, 126.9634224872304 37.58814167454556, 126.9641159099608 37.5889785669954, 126.9642372441088 37.58913797948431, 126.9642400217167 37.5893430475863, 126.9641420421186 37.58958033196943, 126.9641376052684 37.58963500891115, 126.964111613838 37.58998139049233, 126.9645745138506 37.59097261926832, 126.9646881457353 37.59112072592575, 126.9664337494751 37.59293244072924, 126.9680439243682 37.59359205532072, 126.9681386529497 37.59361163575197, 126.9684720131749 37.59352525660245, 126.9685305986841 37.59350459936501, 126.9686423528942 37.59346518297949, 126.9687072740213 37.59341836116727, 126.9687789832648 37.59336665034412, 126.9688718922761 37.59336491426392, 126.9689248439463 37.59336392580813, 126.9698444131133 37.59347509519625, 126.9715476019638 37.59370130879074, 126.9719375264941 37.5938857822259, 126.9735872635534 37.5932890232807)))"
16,서울특별시,종로구,혜화동,11110650,20948,9426,11522,"MULTIPOLYGON (((127.004194817617 37.58795048303252, 127.0041861961394 37.58777010851341, 127.00418355846 37.58771354437431, 127.0041638899187 37.58729006506221, 127.0042997472868 37.58708670556748, 127.0046092171449 37.58699522489745, 127.0047032100521 37.58698587130248, 127.0051246853577 37.58694595193991, 127.0055408341663 37.58696121612009, 127.0056086132096 37.58695248658489, 127.0057356691429 37.58693611847661, 127.0059333543167 37.58690990576036, 127.0065274937981 37.58612822121334, 127.007149932 37.58405894053222, 127.0073549368092 37.58336333585895, 127.0073325396313 37.58320333921623, 127.0061821953815 37.5839612948596, 127.0058045952615 37.5847562782827, 127.0027208294721 37.58372368050578, 127.0017211283405 37.58313363545241, 127.001804621914 37.58253031283793, 126.9982302630869 37.581266540341, 126.9964997845193 37.5810225677299, 126.9965420858462 37.58157369542727, 126.9962654637042 37.58270708341522, 126.9960279551438 37.58328743710543, 126.9958742834118 37.58350761039735, 126.9932892834612 37.58692953701408, 126.9922915706435 37.58719562326232, 126.9912991408195 37.58706519278284, 126.9892992556181 37.58727963952128, 126.9884303806787 37.58742234537463, 126.9883083676072 37.58746911903312, 126.9891359030894 37.59130668631862, 126.9985321547677 37.59250646095414, 126.9987451786228 37.59251637926506, 126.9989741586568 37.59247115853042, 126.9993720050733 37.59236681171856, 127.0006245265884 37.59245336571912, 127.0007859970764 37.59244503534296, 127.0009421942903 37.59239265541499, 127.0015597672751 37.5919187660639, 127.0015812851388 37.59188963716848, 127.0016812280189 37.59175253032394, 127.0019118430581 37.59124875027647, 127.0017869920184 37.59086177213, 127.0016981053348 37.59060226050966, 127.0016582518405 37.59010184631106, 127.0023378187786 37.58915379544608, 127.0023856324952 37.58910399946759, 127.0024304919374 37.58905729163966, 127.0034198794376 37.58835502962636, 127.004194817617 37.58795048303252)))"
17,서울특별시,중구,소공동,11140520,3045,1542,1503,"MULTIPOLYGON (((126.9810873773489 37.56180104199569, 126.9805012403719 37.56151683916288, 126.98030881374 37.561425917917, 126.974074773048 37.55982652702355, 126.9728718496518 37.55971525405376, 126.9720061766122 37.55963626305379, 126.9719362103378 37.55963220503933, 126.9713992376259 37.559602732847, 126.9695924617563 37.56201362245151, 126.9667735382637 37.56579436403002, 126.9671864699827 37.56625582764381, 126.96713423029 37.56630119278387, 126.9671930515086 37.56636085699477, 126.9672974662963 37.56646554636407, 126.9673356767295 37.56650376640693, 126.96792521742 37.567096953691, 126.9680102711992 37.5671825142215, 126.9690483700185 37.56819441770833, 126.9743319356233 37.56926180051753, 126.9753747099125 37.56931556702156, 126.9752753631349 37.56873421770358, 126.9752936778799 37.56865839132112, 126.9756361473965 37.56775642220665, 126.9783506689609 37.56543985096958, 126.9797171138066 37.56588370468476, 126.9805936036098 37.56595007074264, 126.9826462837558 37.56594928530389, 126.9826446107068 37.56589959842637, 126.9826336764851 37.56557663390231, 126.982405273951 37.56406882807667, 126.9822751061127 37.56367472366295, 126.9820381729554 37.56295736377829, 126.9814089488784 37.56216304085677, 126.9810873773489 37.56180104199569)))"
18,서울특별시,중구,회현동,11140540,5864,3193,2671,"MULTIPOLYGON (((126.9853641277334 37.5542383883403, 126.9854270936981 37.55374442699289, 126.9848752560584 37.55330443919126, 126.9844691406694 37.55309310303041, 126.9841472448582 37.55306770320313, 126.9837435515071 37.55303585175674, 126.9830674398687 37.55340364998983, 126.9825657931835 37.55359516605728, 126.9814801985623 37.55392390264949, 126.9808391061314 37.55392559223424, 126.9798293777556 37.55341526609197, 126.9784145816092 37.55427319275102, 126.9771543514164 37.55498193760583, 126.9770508002919 37.55501640626198, 126.9769566193467 37.55504659887737, 126.9769259822011 37.55505641403961, 126.976733724379 37.55502626831344, 126.9766280281852 37.55496270544252, 126.9765784953986 37.55486322576352, 126.9765632276209 37.5546140298507, 126.9765543590337 37.55446889144211, 126.9764950568093 37.55324286193942, 126.9764901023886 37.55313461051957, 126.9766586528781 37.55270834462548, 126.972362318945 37.5543911047289, 126.9690727159189 37.55389693009717, 126.9684889708641 37.55538376368131, 126.9693030071065 37.55802050617245, 126.9705719986678 37.55931400389029, 126.9713992376259 37.559602732847, 126.9719362103378 37.55963220503933, 126.9720061766122 37.55963626305379, 126.9728718496518 37.55971525405376, 126.974074773048 37.55982652702355, 126.98030881374 37.561425917917, 126.9805012403719 37.56151683916288, 126.9810873773489 37.56180104199569, 126.9812613897558 37.5612630369372, 126.9822269965232 37.56009225603972, 126.9822767403792 37.55998461347934, 126.9823557882142 37.5598135516441, 126.9825198169141 37.55944816927764, 126.9826292321009 37.55920313059683, 126.9827367354294 37.55896119397855, 126.9828576402953 37.55866878547204, 126.9830692292914 37.55815594358479, 126.983152003486 37.55795462838923, 126.9832347253186 37.55765754553968, 126.9832466383791 37.55757196958859, 126.9832503805563 37.55754472017957, 126.9832548287599 37.55751229200868, 126.9832782717919 37.55729494431392, 126.9833710599143 37.55605047903621, 126.9833915549397 37.55574737306877, 126.9834250048722 37.5551053084878, 126.983448311028 37.55470093019694, 126.9835826866012 37.55419901603192, 126.9838418993854 37.55396016534691, 126.9850138898426 37.55417434187068, 126.9853641277334 37.5542383883403)))"
19,서울특별시,중구,명동,11140550,3497,1557,1940,"MULTIPOLYGON (((126.9770344988775 37.56919453005455, 126.9775840824726 37.56924090399486, 126.9778027177905 37.56924975808179, 126.9826921386665 37.56889046468609, 126.9827318096513 37.56888500509863, 126.9839702953816 37.56868762394625, 126.984422328848 37.56861523785879, 126.9857170061534 37.56837639374081, 126.9865992431933 37.56821348455564, 126.986787299905 37.56820459472246, 126.9868611882065 37.5682011032103, 126.9888983161631 37.5681085386568, 126.9895162417321 37.56814951948801, 126.9905920323297 37.56822401178576, 126.9908687824506 37.56824324248878, 126.9908288331809 37.56682682674005, 126.9905954746451 37.56618248434521, 126.9897607078794 37.56613381211586, 126.9885933635301 37.56524875593656, 126.988507706234 37.56473693419287, 126.9885087769927 37.56458032970966, 126.98857856306 37.56358464298665, 126.9887605086339 37.56290728134311, 126.9894143177165 37.56286628177801, 126.9898862203742 37.56288048898898, 126.9903177391461 37.56295551238243, 126.9903254158221 37.56289322092849, 126.9903390524704 37.56278211837493, 126.9904800192468 37.56162454704496, 126.9904904812056 37.56150819211315, 126.9905181656508 37.56119884635328, 126.9885445065344 37.5603892181446, 126.9873813993399 37.55838547378224, 126.986915083446 37.55745389208485, 126.9867688833883 37.55732490462495, 126.9858215998338 37.55676185772457, 126.9854233267172 37.55664182059952, 126.9850890721012 37.55657726894294, 126.9848595896799 37.5562991032275, 126.9847642294896 37.55616040222243, 126.9847383914529 37.5561228113901, 126.9847570451699 37.55588506294212, 126.9847889496681 37.55579796062881, 126.9848579735725 37.55560956445576, 126.9853641277334 37.5542383883403, 126.9850138898426 37.55417434187068, 126.9838418993854 37.55396016534691, 126.9835826866012 37.55419901603192, 126.983448311028 37.55470093019694, 126.9834250048722 37.5551053084878, 126.9833915549397 37.55574737306877, 126.9833710599143 37.55605047903621, 126.9832782717919 37.55729494431392, 126.9832548287599 37.55751229200868, 126.9832503805563 37.55754472017957, 126.9832466383791 37.55757196958859, 126.9832347253186 37.55765754553968, 126.983152003486 37.55795462838923, 126.9830692292914 37.55815594358479, 126.9828576402953 37.55866878547204, 126.9827367354294 37.55896119397855, 126.9826292321009 37.55920313059683, 126.9825198169141 37.55944816927764, 126.9823557882142 37.5598135516441, 126.9822767403792 37.55998461347934, 126.9822269965232 37.56009225603972, 126.9812613897558 37.5612630369372, 126.9810873773489 37.56180104199569, 126.9814089488784 37.56216304085677, 126.9820381729554 37.56295736377829, 126.9822751061127 37.56367472366295, 126.982405273951 37.56406882807667, 126.9826336764851 37.56557663390231, 126.9826446107068 37.56589959842637, 126.9826462837558 37.56594928530389, 126.9805936036098 37.56595007074264, 126.9797171138066 37.56588370468476, 126.9783506689609 37.56543985096958, 126.9756361473965 37.56775642220665, 126.9752936778799 37.56865839132112, 126.9752753631349 37.56873421770358, 126.9753747099125 37.56931556702156, 126.9759747282125 37.56933629942576, 126.9770344988775 37.56919453005455)))"
20,서울특별시,중구,필동,11140570,5054,2519,2535,"MULTIPOLYGON (((126.9934719028237 37.56300289844828, 126.9933868777163 37.56270515371175, 126.9933635962742 37.56260925854692, 126.9936378049789 37.56185840513056, 126.993678549768 37.56176705699058, 126.993721419164 37.56171594961831, 126.9942957211817 37.56152715749887, 126.9944941694331 37.56148068747776, 126.9947543863667 37.56142744555073, 126.9953169440536 37.5615179962955, 126.9998681165792 37.56255692535536, 127.001173124308 37.56288031946599, 127.0011042684447 37.56216059578659, 127.0009954435768 37.5610607873972, 127.0003966295817 37.55938989570024, 127.0026381999178 37.55847097051198, 127.0034001472472 37.55881781707909, 127.0035124992557 37.55882617098682, 127.0038787520308 37.55814156499214, 127.0034786137715 37.55669659766394, 127.0033873134398 37.55659255851625, 127.0032833663091 37.55647494585358, 127.0030942022643 37.55629726009495, 127.0027182991199 37.55600161136326, 127.0025119717724 37.55584976706966, 127.0013851373215 37.55547208046729, 127.0010876006803 37.55541786840281, 127.0002877531416 37.55524322950505, 126.998574870732 37.55425575106481, 126.9984921620385 37.55403106653451, 126.9983751123051 37.5532341233711, 126.9974039980855 37.55127639302695, 126.9963947856118 37.55183536255859, 126.9951330985821 37.55226600236355, 126.9944431038432 37.55228220278156, 126.9943787729183 37.55222909020464, 126.9941989305418 37.5520806067647, 126.9925845034365 37.55068560141915, 126.9923599740225 37.55009312642247, 126.9878114172989 37.55149198027539, 126.9854270936981 37.55374442699289, 126.9853641277334 37.5542383883403, 126.9848579735725 37.55560956445576, 126.9847889496681 37.55579796062881, 126.9847570451699 37.55588506294212, 126.9847383914529 37.5561228113901, 126.9847642294896 37.55616040222243, 126.9848595896799 37.5562991032275, 126.9850890721012 37.55657726894294, 126.9854233267172 37.55664182059952, 126.9858215998338 37.55676185772457, 126.9867688833883 37.55732490462495, 126.986915083446 37.55745389208485, 126.9873813993399 37.55838547378224, 126.9885445065344 37.5603892181446, 126.9905181656508 37.56119884635328, 126.9904904812056 37.56150819211315, 126.9904800192468 37.56162454704496, 126.9903390524704 37.56278211837493, 126.9903254158221 37.56289322092849, 126.9903177391461 37.56295551238243, 126.9914289555048 37.56329950229422, 126.9934719028237 37.56300289844828)))"
21,서울특별시,중구,장충동,11140580,5628,2775,2853,"MULTIPOLYGON (((127.0095679109717 37.56302574403669, 127.0093642045607 37.56204704626533, 127.0098505965631 37.5604897693074, 127.0098534236055 37.56042982421882, 127.0098580945646 37.56032864917184, 127.0072650223244 37.55627868493698, 127.0064500581337 37.55561150027972, 127.005225615363 37.55457449259853, 127.005150752117 37.55450654158651, 127.0050610247873 37.55442508008277, 127.0049041678486 37.55428246078831, 127.0045264935684 37.55393498359103, 127.0037757210704 37.55190942615732, 127.0038240000716 37.55158057411367, 127.0038572343282 37.55135431266967, 127.0042252789949 37.55037563944465, 127.0038924990723 37.55019622503125, 127.0026844109379 37.54960075852897, 127.0002531588077 37.5495082452712, 127.0002169569067 37.54951469894092, 126.9999506788974 37.54956217236035, 126.9998683866524 37.54959449776895, 126.9998071820105 37.5496188183286, 126.9993668863353 37.54979177549393, 126.9991043126989 37.54989093079555, 126.998856340108 37.54990824810945, 126.9985217771834 37.54993129931611, 126.9977430665264 37.54935788556125, 126.9953205558618 37.54723726999229, 126.9931941079559 37.54905562616137, 126.9923599740225 37.55009312642247, 126.9925845034365 37.55068560141915, 126.9941989305418 37.5520806067647, 126.9943787729183 37.55222909020464, 126.9944431038432 37.55228220278156, 126.9951330985821 37.55226600236355, 126.9963947856118 37.55183536255859, 126.9974039980855 37.55127639302695, 126.9983751123051 37.5532341233711, 126.9984921620385 37.55403106653451, 126.998574870732 37.55425575106481, 127.0002877531416 37.55524322950505, 127.0010876006803 37.55541786840281, 127.0013851373215 37.55547208046729, 127.0025119717724 37.55584976706966, 127.0027182991199 37.55600161136326, 127.0030942022643 37.55629726009495, 127.0032833663091 37.55647494585358, 127.0033873134398 37.55659255851625, 127.0034786137715 37.55669659766394, 127.0038787520308 37.55814156499214, 127.0035124992557 37.55882617098682, 127.0034001472472 37.55881781707909, 127.0026381999178 37.55847097051198, 127.0003966295817 37.55938989570024, 127.0009954435768 37.5610607873972, 127.0011042684447 37.56216059578659, 127.001173124308 37.56288031946599, 127.0026453110782 37.56242679419468, 127.0029848405177 37.56242709644079, 127.0034893151035 37.56244273931566, 127.0052241602202 37.56249959663678, 127.0061686104376 37.56286634360593, 127.0066991831633 37.56357302852737, 127.0095679109717 37.56302574403669)))"
22,서울특별시,중구,광희동,11140590,6221,3257,2964,"MULTIPOLYGON (((127.0095679109717 37.56302574403669, 127.0066991831633 37.56357302852737, 127.0061686104376 37.56286634360593, 127.0052241602202 37.56249959663678, 127.0034893151035 37.56244273931566, 127.0029848405177 37.56242709644079, 127.0026453110782 37.56242679419468, 127.001173124308 37.56288031946599, 126.9998681165792 37.56255692535536, 126.9953169440536 37.5615179962955, 126.9947543863667 37.56142744555073, 126.9944941694331 37.56148068747776, 126.9942957211817 37.56152715749887, 126.993721419164 37.56171594961831, 126.993678549768 37.56176705699058, 126.9936378049789 37.56185840513056, 126.9933635962742 37.56260925854692, 126.9933868777163 37.56270515371175, 126.9934719028237 37.56300289844828, 126.9950543794229 37.56508622215564, 126.9958903249347 37.56547059864012, 126.9967654471395 37.56566281566984, 126.99982265825 37.56580508171158, 127.0015279851917 37.56588243542868, 127.0027437667691 37.56548725861798, 127.0032268844665 37.56528877683991, 127.0034799567509 37.56565282506402, 127.0035929038956 37.56581534524982, 127.0038036843441 37.56615997655574, 127.0040374471527 37.56654617863747, 127.0041633797754 37.56676190799077, 127.0049877196601 37.5688204361892, 127.0054642962472 37.56931479456103, 127.0066836099916 37.5696477611322, 127.0095852321692 37.56978378493083, 127.0099350962637 37.5693154104235, 127.0116925263386 37.56788955080572, 127.0117637831032 37.56781435763957, 127.0119162744606 37.56646794444975, 127.0119031694115 37.5662372064622, 127.0118862832832 37.56608894060311, 127.0110900167103 37.56586691109503, 127.0105061141851 37.56576534327287, 127.0099809230955 37.56426467231144, 127.0095679109717 37.56302574403669)))"
23,서울특별시,중구,을지로동,11140605,2002,1207,795,"MULTIPOLYGON (((126.9934719028237 37.56300289844828, 126.9914289555048 37.56329950229422, 126.9903177391461 37.56295551238243, 126.9898862203742 37.56288048898898, 126.9894143177165 37.56286628177801, 126.9887605086339 37.56290728134311, 126.98857856306 37.56358464298665, 126.9885087769927 37.56458032970966, 126.988507706234 37.56473693419287, 126.9885933635301 37.56524875593656, 126.9897607078794 37.56613381211586, 126.9905954746451 37.56618248434521, 126.9908288331809 37.56682682674005, 126.9908687824506 37.56824324248878, 126.9966966265454 37.56870989125176, 126.9967966683521 37.56872389200475, 126.9969766239248 37.56874939188403, 126.9979240697465 37.56888637378169, 126.9982973899722 37.56894091593279, 126.9983491068369 37.56895088287298, 127.0016222491592 37.56959157448218, 127.0066836099916 37.5696477611322, 127.0054642962472 37.56931479456103, 127.0049877196601 37.5688204361892, 127.0041633797754 37.56676190799077, 127.0040374471527 37.56654617863747, 127.0038036843441 37.56615997655574, 127.0035929038956 37.56581534524982, 127.0034799567509 37.56565282506402, 127.0032268844665 37.56528877683991, 127.0027437667691 37.56548725861798, 127.0015279851917 37.56588243542868, 126.99982265825 37.56580508171158, 126.9967654471395 37.56566281566984, 126.9958903249347 37.56547059864012, 126.9950543794229 37.56508622215564, 126.9934719028237 37.56300289844828)))"
24,서울특별시,중구,신당5동,11140650,10846,5312,5534,"MULTIPOLYGON (((127.0236152478631 37.56516886904607, 127.0267054954105 37.56498976245136, 127.0267568039915 37.56428904775203, 127.0267075541278 37.5638822383187, 127.0265912494255 37.56358432685774, 127.0264991149577 37.56338741823071, 127.0264815834279 37.56335578267504, 127.0263954842566 37.5632072285016, 127.0262652068204 37.56299376211291, 127.0235298861134 37.56073011014464, 127.0234949744223 37.56071797409027, 127.0233348751008 37.56074436830169, 127.02288256251 37.5607628216526, 127.0223074679285 37.56083711087956, 127.0220347504014 37.56087994791072, 127.021791598256 37.56094543779678, 127.0213177605131 37.56112040737801, 127.020951324216 37.56132059798269, 127.0208809023051 37.56136879759237, 127.0206655724089 37.56151886076881, 127.0204962493254 37.56165900898949, 127.0187739617245 37.56339160479137, 127.0159907184426 37.564122672606, 127.0180743572028 37.56556664980869, 127.0205925754728 37.56575807897013, 127.0236152478631 37.56516886904607)))"
25,서울특별시,중구,황학동,11140670,13669,6607,7062,"MULTIPOLYGON (((127.0236152478631 37.56516886904607, 127.0205925754728 37.56575807897013, 127.0180743572028 37.56556664980869, 127.017699086111 37.56998577691102, 127.0175133756155 37.57029101296999, 127.0188185365185 37.57098451977708, 127.0233681239995 37.5717398548992, 127.0235977494824 37.56580425008264, 127.0236152478631 37.56516886904607)))"
26,서울특별시,중구,중림동,11140680,13007,6534,6473,"MULTIPOLYGON (((126.9713992376259 37.559602732847, 126.9705719986678 37.55931400389029, 126.9693030071065 37.55802050617245, 126.9684889708641 37.55538376368131, 126.9657200180734 37.55411165026642, 126.9652018287633 37.55374763829929, 126.9648491386671 37.55349478944745, 126.9623868743941 37.55150399398249, 126.9621362215918 37.55192200380381, 126.9620685757563 37.55207943160345, 126.961707249935 37.55296638811462, 126.9616618402714 37.55334171879928, 126.9617027044694 37.55534292838134, 126.961838039219 37.55540660812221, 126.9619841986044 37.55535206667223, 126.962020870108 37.55533783023146, 126.9620501845675 37.55532645358582, 126.9629271112777 37.55622661812477, 126.9630980674387 37.55642298000916, 126.9632159136027 37.55715025898734, 126.9630366208267 37.5581825818219, 126.9614834863961 37.55885377187588, 126.9620679010407 37.5592609165609, 126.9636095048223 37.55930961772834, 126.9636582475572 37.55932223359292, 126.9637104077843 37.55933653155207, 126.9637585361085 37.55934972955886, 126.9638741663953 37.55940884226382, 126.9641821532124 37.55956741736362, 126.9643282875138 37.55965012922717, 126.9652380139032 37.5601710326246, 126.9655385971901 37.56038383445967, 126.9661874679054 37.5608457063168, 126.9665350198628 37.56108049991978, 126.9666124906869 37.561132677408, 126.9669014319327 37.56130638041186, 126.9673819387459 37.5614955534074, 126.9679222803674 37.56164334197116, 126.9680819597247 37.56167898870061, 126.9688994469641 37.56186068414217, 126.9695924617563 37.56201362245151, 126.9713992376259 37.559602732847)))"
27,서울특별시,중구,신당동,11140615,9336,4570,4766,"MULTIPOLYGON (((127.0180743572028 37.56556664980869, 127.0159907184426 37.564122672606, 127.0142619699071 37.56108043774584, 127.0128463498962 37.56058193139436, 127.0096986028635 37.56198606213606, 127.0093642045607 37.56204704626533, 127.0095679109717 37.56302574403669, 127.0099809230955 37.56426467231144, 127.0105061141851 37.56576534327287, 127.0110900167103 37.56586691109503, 127.0118862832832 37.56608894060311, 127.0119031694115 37.5662372064622, 127.0119162744606 37.56646794444975, 127.0117637831032 37.56781435763957, 127.0116925263386 37.56788955080572, 127.0099350962637 37.5693154104235, 127.0095852321692 37.56978378493083, 127.0101040119439 37.56978255882795, 127.011285951644 37.56978182425201, 127.0116157594745 37.56978206242719, 127.0153758582863 37.56980657136566, 127.0156654207759 37.56980859794676, 127.0157629720032 37.56980928655595, 127.0158654089304 37.56981531307181, 127.016005640567 37.56982380100295, 127.0161766627633 37.56986280930545, 127.0163801750635 37.56991209062485, 127.0166415466344 37.56998864893561, 127.0167409868101 37.57001950356381, 127.0168696861816 37.57005943724952, 127.0170003453341 37.5701027859073, 127.0171373467301 37.57014954041541, 127.0172783400352 37.5702024312381, 127.0175133756155 37.57029101296999, 127.017699086111 37.56998577691102, 127.0180743572028 37.56556664980869)))"
28,서울특별시,중구,다산동,11140625,15075,7303,7772,"MULTIPOLYGON (((127.0128463498962 37.56058193139436, 127.0136420605334 37.56022186375173, 127.0127192943372 37.55845892551616, 127.0110556504706 37.55553052715992, 127.0095991668427 37.55340306262838, 127.0074208884102 37.5490873206518, 127.0074011692726 37.54892536484815, 127.0073687724684 37.54868749848173, 127.0071789289465 37.54829123780617, 127.0070398782396 37.54813292100664, 127.0069799856753 37.5480805999203, 127.0069413892981 37.54804688147449, 127.0068562561395 37.54797329211279, 127.0065838294067 37.54786962448767, 127.0059212032467 37.54771137160115, 127.0056934348484 37.5477025315019, 127.0053057362477 37.547712171131, 127.0053075969663 37.54773809546151, 127.0053100902793 37.54777022103047, 127.0053134550067 37.54781352249104, 127.0058944050891 37.54820461733567, 127.0057835896978 37.54822566429836, 127.0057366184737 37.5482345082359, 127.0055411191471 37.5482674903744, 127.0054215005781 37.54828528681733, 127.0053201488406 37.54830036548167, 127.0047155966243 37.54834740546745, 127.0046307895352 37.54856352705784, 127.0044701900094 37.54897281441067, 127.0043874011466 37.5491865376636, 127.004378547336 37.54956281427435, 127.0044022483744 37.5496644238298, 127.0042252789949 37.55037563944465, 127.0038572343282 37.55135431266967, 127.0038240000716 37.55158057411367, 127.0037757210704 37.55190942615732, 127.0045264935684 37.55393498359103, 127.0049041678486 37.55428246078831, 127.0050610247873 37.55442508008277, 127.005150752117 37.55450654158651, 127.005225615363 37.55457449259853, 127.0064500581337 37.55561150027972, 127.0072650223244 37.55627868493698, 127.0098580945646 37.56032864917184, 127.0098534236055 37.56042982421882, 127.0098505965631 37.5604897693074, 127.0093642045607 37.56204704626533, 127.0096986028635 37.56198606213606, 127.0128463498962 37.56058193139436)))"
29,서울특별시,중구,약수동,11140635,17760,8386,9374,"MULTIPOLYGON (((127.016306137489 37.55301149563815, 127.0132076195527 37.54994422861261, 127.0116576475451 37.54851152298635, 127.0114799688542 37.54841614618272, 127.0108670535388 37.54811841641107, 127.0108132431098 37.54809814744943, 127.0107823571481 37.54808651825122, 127.0106819407089 37.54807821534514, 127.0086060357027 37.5439797142403, 127.0072581374889 37.54381073731256, 127.0048426049037 37.5461822628338, 127.0053057362477 37.547712171131, 127.0056934348484 37.5477025315019, 127.0059212032467 37.54771137160115, 127.0065838294067 37.54786962448767, 127.0068562561395 37.54797329211279, 127.0069413892981 37.54804688147449, 127.0069799856753 37.5480805999203, 127.0070398782396 37.54813292100664, 127.0071789289465 37.54829123780617, 127.0073687724684 37.54868749848173, 127.0074011692726 37.54892536484815, 127.0074208884102 37.5490873206518, 127.0095991668427 37.55340306262838, 127.0110556504706 37.55553052715992, 127.0121576265197 37.55506302518268, 127.0119725354406 37.55479974215443, 127.0119571098385 37.55477714915557, 127.0125378180455 37.55394579583076, 127.0129159993624 37.55378624025451, 127.0132740280217 37.55370657717142, 127.0135375085843 37.55364806575889, 127.0140055366636 37.55402846099434, 127.0140541690575 37.55422188806136, 127.0140702576305 37.55426451151434, 127.0141018473895 37.55434432986901, 127.0142076932264 37.55437219348869, 127.0142975125095 37.55439583586374, 127.0144953793999 37.55443608371393, 127.0146832702917 37.55438496545118, 127.0157404625123 37.55349815940938, 127.016306137489 37.55301149563815)))"
30,서울특별시,중구,청구동,11140645,14595,6952,7643,"MULTIPOLYGON (((127.0193708860018 37.55749921354852, 127.0194639028375 37.5573396016988, 127.0189069084919 37.55713452973983, 127.01876860869 37.5570731250229, 127.0185886851535 37.55699127006635, 127.0183658575566 37.55686980577583, 127.0180042334842 37.55665538618447, 127.0179241335154 37.5566004734223, 127.0178802397968 37.55657037839764, 127.0174114356653 37.55598265791892, 127.016306137489 37.55301149563815, 127.0157404625123 37.55349815940938, 127.0146832702917 37.55438496545118, 127.0144953793999 37.55443608371393, 127.0142975125095 37.55439583586374, 127.0142076932264 37.55437219348869, 127.0141018473895 37.55434432986901, 127.0140702576305 37.55426451151434, 127.0140541690575 37.55422188806136, 127.0140055366636 37.55402846099434, 127.0135375085843 37.55364806575889, 127.0132740280217 37.55370657717142, 127.0129159993624 37.55378624025451, 127.0125378180455 37.55394579583076, 127.0119571098385 37.55477714915557, 127.0119725354406 37.55479974215443, 127.0121576265197 37.55506302518268, 127.0110556504706 37.55553052715992, 127.0127192943372 37.55845892551616, 127.0136420605334 37.56022186375173, 127.0128463498962 37.56058193139436, 127.0142619699071 37.56108043774584, 127.0143490062903 37.56104947031874, 127.0139315322627 37.56028163813347, 127.0147371529617 37.55988647919251, 127.0157831481134 37.55948327918231, 127.0158553318878 37.55945996526325, 127.0162106830701 37.55934984658008, 127.0163348257279 37.55932289109422, 127.016455158616 37.55929676714265, 127.0165648247297 37.55930059629596, 127.0166433366337 37.55930542449374, 127.016703243689 37.55931410636543, 127.0188639281128 37.55842553877979, 127.0193708860018 37.55749921354852)))"
31,서울특별시,중구,동화동,11140665,11064,5316,5748,"MULTIPOLYGON (((127.0233348751008 37.56074436830169, 127.0228571463334 37.55786826039839, 127.021824292577 37.55770941022003, 127.0193708860018 37.55749921354852, 127.0188639281128 37.55842553877979, 127.016703243689 37.55931410636543, 127.0166433366337 37.55930542449374, 127.0165648247297 37.55930059629596, 127.016455158616 37.55929676714265, 127.0163348257279 37.55932289109422, 127.0162106830701 37.55934984658008, 127.0158553318878 37.55945996526325, 127.0157831481134 37.55948327918231, 127.0147371529617 37.55988647919251, 127.0139315322627 37.56028163813347, 127.0143490062903 37.56104947031874, 127.0142619699071 37.56108043774584, 127.0159907184426 37.564122672606, 127.0187739617245 37.56339160479137, 127.0204962493254 37.56165900898949, 127.0206655724089 37.56151886076881, 127.0208809023051 37.56136879759237, 127.020951324216 37.56132059798269, 127.0213177605131 37.56112040737801, 127.021791598256 37.56094543779678, 127.0220347504014 37.56087994791072, 127.0223074679285 37.56083711087956, 127.02288256251 37.5607628216526, 127.0233348751008 37.56074436830169)))"
32,서울특별시,용산구,후암동,11170510,18547,9056,9491,"MULTIPOLYGON (((126.9854270936981 37.55374442699289, 126.9878114172989 37.55149198027539, 126.9873735964717 37.54950485781342, 126.9860321445812 37.54784617607479, 126.9839886972747 37.54662607468777, 126.9838004560955 37.54652835678399, 126.9836121515498 37.54651210232021, 126.9777778025731 37.54584839561146, 126.9751079076888 37.54550531320784, 126.9742941980494 37.54752972829198, 126.9744096749036 37.54897713354276, 126.9751455858006 37.55113497136637, 126.9757872629832 37.55225493133794, 126.9766586528781 37.55270834462548, 126.9764901023886 37.55313461051957, 126.9764950568093 37.55324286193942, 126.9765543590337 37.55446889144211, 126.9765632276209 37.5546140298507, 126.9765784953986 37.55486322576352, 126.9766280281852 37.55496270544252, 126.976733724379 37.55502626831344, 126.9769259822011 37.55505641403961, 126.9769566193467 37.55504659887737, 126.9770508002919 37.55501640626198, 126.9771543514164 37.55498193760583, 126.9784145816092 37.55427319275102, 126.9798293777556 37.55341526609197, 126.9808391061314 37.55392559223424, 126.9814801985623 37.55392390264949, 126.9825657931835 37.55359516605728, 126.9830674398687 37.55340364998983, 126.9837435515071 37.55303585175674, 126.9841472448582 37.55306770320313, 126.9844691406694 37.55309310303041, 126.9848752560584 37.55330443919126, 126.9854270936981 37.55374442699289)))"
33,서울특별시,용산구,용산2가동,11170520,11831,5820,6011,"MULTIPOLYGON (((126.9923599740225 37.55009312642247, 126.9931941079559 37.54905562616137, 126.9914173305739 37.54782780645426, 126.9909468392174 37.54636897172698, 126.9903468549142 37.54543348595663, 126.9891828085885 37.5436978629689, 126.9885638094487 37.5430549992532, 126.9884651772964 37.54280016576664, 126.9884287504472 37.54270568160015, 126.9883977404974 37.5426252368954, 126.986968656804 37.53890209031955, 126.9868265394888 37.53837418226117, 126.9868161099269 37.5383352165837, 126.9867976471161 37.53826620099147, 126.9867810153436 37.53820385434049, 126.9867882705315 37.53745576414635, 126.9869532560824 37.53568147624402, 126.9873755686082 37.53443991328637, 126.9878117536251 37.53427505758517, 126.9878859289584 37.53438457717329, 126.9879720842405 37.53431180604081, 126.9880869506672 37.53421492194899, 126.9882150561969 37.534109903631, 126.9882917542364 37.53405170850128, 126.9883519310413 37.5340058650783, 126.9884622663704 37.53390606764161, 126.9885341187775 37.53383773188099, 126.9886132166536 37.53376250506673, 126.9887516133031 37.53360249325218, 126.9887772145432 37.53357280537876, 126.9889185062553 37.53339314650057, 126.9889934365951 37.53329657539307, 126.9893563571705 37.53277423422001, 126.9894533533132 37.53261677271766, 126.9895487811643 37.53246184616522, 126.9897125531348 37.53219655582798, 126.9898248809026 37.53201461641984, 126.989978365063 37.53180798182619, 126.9905723470051 37.53100945495161, 126.9908527183823 37.53066138988451, 126.9910546865319 37.53036180263025, 126.9911198232823 37.53026489946725, 126.9913615037273 37.52990531837455, 126.991333393506 37.5294656660908, 126.9909124972733 37.5294628474598, 126.9884637072181 37.52944775921915, 126.9857943299071 37.52943165094015, 126.9837990036324 37.52941957522319, 126.9837974929737 37.53115457305566, 126.9792427328392 37.53277401117865, 126.9790263534719 37.53469515620201, 126.9790580557407 37.53796835994041, 126.9763966330775 37.53807151143617, 126.9746020550967 37.54066393766045, 126.9736644254174 37.54442064615116, 126.9734796260467 37.54526263583127, 126.9741410378999 37.54536130026506, 126.9751079076888 37.54550531320784, 126.9777778025731 37.54584839561146, 126.9836121515498 37.54651210232021, 126.9838004560955 37.54652835678399, 126.9839886972747 37.54662607468777, 126.9860321445812 37.54784617607479, 126.9873735964717 37.54950485781342, 126.9878114172989 37.55149198027539, 126.9923599740225 37.55009312642247)))"
34,서울특별시,용산구,남영동,11170530,8521,5119,3402,"MULTIPOLYGON (((126.9766586528781 37.55270834462548, 126.9757872629832 37.55225493133794, 126.9751455858006 37.55113497136637, 126.9744096749036 37.54897713354276, 126.9742941980494 37.54752972829198, 126.9751079076888 37.54550531320784, 126.9741410378999 37.54536130026506, 126.9734796260467 37.54526263583127, 126.9736644254174 37.54442064615116, 126.9746020550967 37.54066393766045, 126.9763966330775 37.53807151143617, 126.9790580557407 37.53796835994041, 126.9790263534719 37.53469515620201, 126.9787837898104 37.53468397810137, 126.97613392393 37.53456747065809, 126.9750684972635 37.53537281654359, 126.9739137475633 37.53776919561428, 126.9738582297974 37.53798474070869, 126.9733833465178 37.53982137957513, 126.9732079511342 37.54031634100102, 126.9715574805063 37.53934641964027, 126.9708604054035 37.53913972358701, 126.9707142905423 37.54160089942361, 126.9710282671629 37.54172054997616, 126.971035439671 37.54260394499357, 126.9710310667832 37.54372272619241, 126.9709560605754 37.54772889043416, 126.9709122510352 37.54832133132837, 126.9708959015908 37.54853307514748, 126.9700451117015 37.55217634377422, 126.9692996891288 37.55203554992678, 126.9691668884885 37.55269179994136, 126.9691051437313 37.55301713448996, 126.9690992667385 37.55305002080549, 126.9690940629861 37.55319563279038, 126.9690921775332 37.55325697820221, 126.9690727159189 37.55389693009717, 126.972362318945 37.5543911047289, 126.9766586528781 37.55270834462548)))"
35,서울특별시,용산구,원효로2동,11170570,14779,6944,7835,"MULTIPOLYGON (((126.9606974631578 37.53570360684, 126.9606452339531 37.53553654629352, 126.9615863354054 37.53314550670364, 126.9614192735113 37.53316164434676, 126.9596750917351 37.53332155352994, 126.9596128642481 37.53330886440236, 126.9587392054552 37.53312460394796, 126.9574120688592 37.53274220058974, 126.9566707944698 37.53244021987122, 126.9551095525442 37.53176377332507, 126.9548437411843 37.53164311753441, 126.9546061925035 37.53152596903676, 126.9540709834169 37.53139015199027, 126.9536480323846 37.53118915964199, 126.9519606785725 37.53035548721953, 126.9502365347082 37.52942922190534, 126.9476859905017 37.52805853392996, 126.9474866071258 37.52795132294936, 126.9463376417002 37.52733348001347, 126.9435704355748 37.52941828315847, 126.945003636551 37.534466957167, 126.9450815156394 37.53493489864969, 126.9454327557922 37.53519236537115, 126.9460519636596 37.53559510609899, 126.9461861413993 37.5356532776357, 126.9463955384538 37.5357421699634, 126.9478106062036 37.53562256839294, 126.9494217055138 37.53587008443885, 126.9507583358477 37.53611741995191, 126.9511269139266 37.53621264875299, 126.9513102441408 37.53629462225033, 126.9522346649203 37.53680367004696, 126.952826098804 37.53728412764071, 126.9529684675836 37.53742578275144, 126.9529854531841 37.53751886545702, 126.952994745193 37.53757012322018, 126.9530135509406 37.53767483005122, 126.9530097583764 37.53780663495228, 126.9530081251642 37.53784721518655, 126.9538624172201 37.53729455479971, 126.9549537139119 37.53743927455483, 126.9581155609715 37.5366054658492, 126.9582775544907 37.53655806795305, 126.9606734737231 37.53574060679551, 126.9606974631578 37.53570360684)))"
36,서울특별시,용산구,효창동,11170580,10179,4858,5321,"MULTIPOLYGON (((126.9631996202727 37.54867748111055, 126.963406772186 37.54840351124817, 126.964548823477 37.54295215056657, 126.9648841563662 37.54146982415098, 126.9638582447411 37.53861465035996, 126.9637582923822 37.53864348860074, 126.9631100352727 37.53883309403513, 126.9630670835169 37.53884427829377, 126.9625638874738 37.53897043165958, 126.9624884920269 37.53898749357242, 126.9623881537266 37.53901019249816, 126.9615921115853 37.53922964989636, 126.9608948265769 37.5394867335047, 126.9607457785377 37.5395536542225, 126.9605882027136 37.53939912001209, 126.9604860133896 37.53921496880552, 126.9602033943621 37.53927123476144, 126.9596113433283 37.53941101234003, 126.9579079333384 37.53987866796961, 126.9575657694945 37.54011639613953, 126.9565075360991 37.5407048529434, 126.9577002539413 37.54208264069798, 126.9578032919165 37.54289883621519, 126.9586293379188 37.54558188748002, 126.9616204984659 37.54769695633127, 126.9629344528892 37.54878005031158, 126.9631996202727 37.54867748111055)))"
37,서울특별시,용산구,용문동,11170590,12649,6066,6583,"MULTIPOLYGON (((126.9638582447411 37.53861465035996, 126.9636992905088 37.53828718720153, 126.9631692346343 37.53742398892736, 126.9619673960104 37.53675726227117, 126.9610586941201 37.53608375661641, 126.9607157861052 37.5357622116199, 126.9606974631578 37.53570360684, 126.9606734737231 37.53574060679551, 126.9582775544907 37.53655806795305, 126.9581155609715 37.5366054658492, 126.9549537139119 37.53743927455483, 126.9538624172201 37.53729455479971, 126.9530081251642 37.53784721518655, 126.953843087381 37.53848988563785, 126.956400908531 37.54058497383463, 126.9565075360991 37.5407048529434, 126.9575657694945 37.54011639613953, 126.9579079333384 37.53987866796961, 126.9596113433283 37.53941101234003, 126.9602033943621 37.53927123476144, 126.9604860133896 37.53921496880552, 126.9605882027136 37.53939912001209, 126.9607457785377 37.5395536542225, 126.9608948265769 37.5394867335047, 126.9615921115853 37.53922964989636, 126.9623881537266 37.53901019249816, 126.9624884920269 37.53898749357242, 126.9625638874738 37.53897043165958, 126.9630670835169 37.53884427829377, 126.9631100352727 37.53883309403513, 126.9637582923822 37.53864348860074, 126.9638582447411 37.53861465035996)))"
38,서울특별시,용산구,이촌1동,11170630,29251,13741,15510,"MULTIPOLYGON (((126.9762303400895 37.521791225937, 126.9775275650314 37.52137784226018, 126.9798597083789 37.5206544340852, 126.9811232915657 37.52027263527387, 126.9824592868874 37.51986950770888, 126.9828054970988 37.51961413835937, 126.9829562331436 37.51939286241729, 126.9829913120295 37.51923187638943, 126.9830073844751 37.51915758502522, 126.9830627990099 37.51870846735098, 126.9830944611138 37.51781269489282, 126.9830983059939 37.51756371256745, 126.9831041191448 37.51713108787241, 126.9831012434127 37.51652266098053, 126.9830909247144 37.51627474330869, 126.9830661233613 37.51607746344012, 126.9830135818706 37.515798940222, 126.9827751447049 37.51458444747271, 126.982485579607 37.51350614288573, 126.9801379051013 37.51211780751312, 126.9755930365814 37.51229601135129, 126.9676723087916 37.51260534777674, 126.9646025199765 37.51277850390171, 126.9634258740935 37.51304921329295, 126.9629562589911 37.51315748588056, 126.962401915494 37.5133577120267, 126.9571981610347 37.51541394716001, 126.9577025182473 37.51607302089852, 126.9581821424148 37.5167422237669, 126.9586827689474 37.51744081488779, 126.9590937035781 37.51802632392783, 126.9595213446973 37.51874711095594, 126.9617588321463 37.52262638707772, 126.9618154559879 37.52260191650202, 126.9622079258954 37.5224357687129, 126.9631964233534 37.52218112674079, 126.9632495712018 37.52216784799834, 126.9637873276632 37.52203846783005, 126.9639706290606 37.52202352622093, 126.964436996044 37.52198620774411, 126.9645685240047 37.52199018417411, 126.9651384706399 37.52200854033426, 126.9653835728586 37.52203789847504, 126.9654904016198 37.52205069448154, 126.9658875501367 37.52209981222692, 126.9663318825977 37.52215836629941, 126.9670136172901 37.52229080339814, 126.9678604745758 37.52245911901552, 126.9693606986032 37.52275204859384, 126.9696687524836 37.52279849992201, 126.9698926704379 37.52283156631118, 126.9701803036901 37.52287403080195, 126.9720605476721 37.52304018836505, 126.9725166446824 37.52295659773497, 126.9726300711119 37.52291992345089, 126.9762303400895 37.521791225937)))"
39,서울특별시,용산구,이촌2동,11170640,9025,4254,4771,"MULTIPOLYGON (((126.9617588321463 37.52262638707772, 126.9595213446973 37.51874711095594, 126.9590937035781 37.51802632392783, 126.9586827689474 37.51744081488779, 126.9581821424148 37.5167422237669, 126.9577025182473 37.51607302089852, 126.9571981610347 37.51541394716001, 126.9534208371022 37.51753826503405, 126.9514213993267 37.51918635737942, 126.9504023930373 37.52002668967632, 126.9496153697221 37.52116318540098, 126.9479410860183 37.52358226240619, 126.9477164998475 37.52536025593309, 126.947419988147 37.52585911923523, 126.9467095221252 37.52705008388215, 126.9463376417002 37.52733348001347, 126.9474866071258 37.52795132294936, 126.9476859905017 37.52805853392996, 126.9502365347082 37.52942922190534, 126.9519606785725 37.53035548721953, 126.9536480323846 37.53118915964199, 126.9540709834169 37.53139015199027, 126.9546061925035 37.53152596903676, 126.9554478901703 37.52696676348369, 126.9566573295604 37.52572061009261, 126.956885838974 37.52551319462444, 126.9569780050919 37.52543061290714, 126.9570147073702 37.5253977380828, 126.9572036491524 37.52523823801911, 126.9575271130461 37.52496519033369, 126.9579619187673 37.52469903347836, 126.9593302399657 37.52386310430765, 126.9601961605454 37.52334822415668, 126.9604268523151 37.52323548255101, 126.9611359322327 37.52288944575371, 126.9617588321463 37.52262638707772)))"
40,서울특별시,용산구,이태원1동,11170650,9086,4749,4337,"MULTIPOLYGON (((126.9978700030165 37.53261350853067, 126.994798752438 37.52873478412916, 126.991333393506 37.5294656660908, 126.9913615037273 37.52990531837455, 126.9911198232823 37.53026489946725, 126.9910546865319 37.53036180263025, 126.9908527183823 37.53066138988451, 126.9905723470051 37.53100945495161, 126.989978365063 37.53180798182619, 126.9898248809026 37.53201461641984, 126.9897125531348 37.53219655582798, 126.9895487811643 37.53246184616522, 126.9894533533132 37.53261677271766, 126.9893563571705 37.53277423422001, 126.9889934365951 37.53329657539307, 126.9889185062553 37.53339314650057, 126.9887772145432 37.53357280537876, 126.9887516133031 37.53360249325218, 126.9886132166536 37.53376250506673, 126.9885341187775 37.53383773188099, 126.9884622663704 37.53390606764161, 126.9883519310413 37.5340058650783, 126.9882917542364 37.53405170850128, 126.9882150561969 37.534109903631, 126.9880869506672 37.53421492194899, 126.9879720842405 37.53431180604081, 126.9878859289584 37.53438457717329, 126.9897626230362 37.53564905016137, 126.9945626809832 37.53834558071173, 126.9950951410077 37.53869713230723, 126.9953415994772 37.53897197228811, 126.9951238370298 37.53821841191651, 126.9970362064646 37.53335138412458, 126.9978700030165 37.53261350853067)))"
41,서울특별시,용산구,이태원2동,11170660,10812,5088,5724,"MULTIPOLYGON (((126.9953205558618 37.54723726999229, 126.9965053563669 37.54602099719253, 126.9978623988136 37.54221750912124, 126.9978431735476 37.54181731755035, 126.9978050580553 37.54125480687934, 126.9977809633374 37.54122203943294, 126.9975633376285 37.54092611037149, 126.9975415975371 37.54089672394787, 126.997395445649 37.54076765038533, 126.9973390465254 37.54071784500693, 126.996935573597 37.54053923661548, 126.9964973253067 37.54026694082628, 126.9958578356203 37.53984285311787, 126.9956583424044 37.53971013353474, 126.9955169520908 37.53961605942692, 126.9954160526438 37.53947141208202, 126.9953961362938 37.53939834454324, 126.9953739370821 37.53931684862134, 126.9953581609513 37.5392487201466, 126.9953402543276 37.539171388778, 126.9953415994772 37.53897197228811, 126.9950951410077 37.53869713230723, 126.9945626809832 37.53834558071173, 126.9897626230362 37.53564905016137, 126.9878859289584 37.53438457717329, 126.9878117536251 37.53427505758517, 126.9873755686082 37.53443991328637, 126.9869532560824 37.53568147624402, 126.9867882705315 37.53745576414635, 126.9867810153436 37.53820385434049, 126.9867976471161 37.53826620099147, 126.9868161099269 37.5383352165837, 126.9868265394888 37.53837418226117, 126.986968656804 37.53890209031955, 126.9883977404974 37.5426252368954, 126.9884287504472 37.54270568160015, 126.9884651772964 37.54280016576664, 126.9885638094487 37.5430549992532, 126.9891828085885 37.5436978629689, 126.9903468549142 37.54543348595663, 126.9909468392174 37.54636897172698, 126.9914173305739 37.54782780645426, 126.9931941079559 37.54905562616137, 126.9953205558618 37.54723726999229)))"
42,서울특별시,용산구,서빙고동,11170690,14122,6821,7301,"MULTIPOLYGON (((126.991333393506 37.5294656660908, 126.994798752438 37.52873478412916, 126.9953624262944 37.52863805423126, 126.996633922797 37.52794943849151, 126.9967413090111 37.52787711637144, 126.9968216491616 37.5278026418634, 126.9970921512941 37.52691596272781, 126.9969252497656 37.52665860860252, 126.9966903877571 37.52628330283175, 126.9965940375438 37.52588517079659, 126.9969053585315 37.5251857020881, 126.9970117046071 37.5249912282865, 126.9975381318382 37.52475348366255, 126.9996775446559 37.52309393460745, 127.0000829292034 37.52276102347383, 127.0002623072498 37.52248348046712, 127.0004048199286 37.52211341043997, 127.0003873205798 37.51794907783463, 126.9959414896796 37.51574214068492, 126.9893793179576 37.5127079765066, 126.9886237309889 37.51409714647897, 126.9849924616736 37.51363306660695, 126.982485579607 37.51350614288573, 126.9827751447049 37.51458444747271, 126.9830135818706 37.515798940222, 126.9830661233613 37.51607746344012, 126.9830909247144 37.51627474330869, 126.9831012434127 37.51652266098053, 126.9831041191448 37.51713108787241, 126.9830983059939 37.51756371256745, 126.9830944611138 37.51781269489282, 126.9830627990099 37.51870846735098, 126.9830073844751 37.51915758502522, 126.9829913120295 37.51923187638943, 126.9829562331436 37.51939286241729, 126.9828054970988 37.51961413835937, 126.9824592868874 37.51986950770888, 126.9811232915657 37.52027263527387, 126.9798597083789 37.5206544340852, 126.9775275650314 37.52137784226018, 126.9762303400895 37.521791225937, 126.9792427328392 37.53277401117865, 126.9837974929737 37.53115457305566, 126.9837990036324 37.52941957522319, 126.9857943299071 37.52943165094015, 126.9884637072181 37.52944775921915, 126.9909124972733 37.5294628474598, 126.991333393506 37.5294656660908)))"
43,서울특별시,용산구,보광동,11170700,15897,8039,7858,"MULTIPOLYGON (((127.0079721761886 37.52458897654878, 127.0044274316538 37.52026117367696, 127.0003873205798 37.51794907783463, 127.0004048199286 37.52211341043997, 127.0002623072498 37.52248348046712, 127.0000829292034 37.52276102347383, 126.9996775446559 37.52309393460745, 126.9975381318382 37.52475348366255, 126.9970117046071 37.5249912282865, 126.9969053585315 37.5251857020881, 126.9965940375438 37.52588517079659, 126.9966903877571 37.52628330283175, 126.9969252497656 37.52665860860252, 126.9970921512941 37.52691596272781, 126.9968216491616 37.5278026418634, 126.9967413090111 37.52787711637144, 126.996633922797 37.52794943849151, 126.9953624262944 37.52863805423126, 126.994798752438 37.52873478412916, 126.9978700030165 37.53261350853067, 126.9981005623741 37.53264273522102, 127.0009161688242 37.53167330201919, 127.0029936018478 37.53041678880711, 127.0033169624272 37.53019055753079, 127.0035445245662 37.53000899034082, 127.0036036475541 37.52993496735662, 127.0037270548527 37.5294656646028, 127.0036929856528 37.52927388469134, 127.0034519483255 37.5291410485523, 127.0033789212051 37.5290743477929, 127.0031618845765 37.52882886168496, 127.0028874330769 37.52838494390736, 127.0028546670898 37.52817198740478, 127.0028502450567 37.5281425215702, 127.0038915707817 37.52716555266758, 127.0042308771999 37.52698557917714, 127.0047913738895 37.52672879151885, 127.007299455643 37.5251359980717, 127.0079721761886 37.52458897654878)))"
44,서울특별시,용산구,청파동,11170555,20715,9728,10987,"MULTIPOLYGON (((126.9690727159189 37.55389693009717, 126.9690921775332 37.55325697820221, 126.9690940629861 37.55319563279038, 126.9690992667385 37.55305002080549, 126.9691051437313 37.55301713448996, 126.9691668884885 37.55269179994136, 126.9692996891288 37.55203554992678, 126.9700451117015 37.55217634377422, 126.9708959015908 37.54853307514748, 126.9709122510352 37.54832133132837, 126.9709560605754 37.54772889043416, 126.9710310667832 37.54372272619241, 126.971035439671 37.54260394499357, 126.9710282671629 37.54172054997616, 126.9707142905423 37.54160089942361, 126.9648841563662 37.54146982415098, 126.964548823477 37.54295215056657, 126.963406772186 37.54840351124817, 126.9631996202727 37.54867748111055, 126.9623868743941 37.55150399398249, 126.9648491386671 37.55349478944745, 126.9652018287633 37.55374763829929, 126.9657200180734 37.55411165026642, 126.9684889708641 37.55538376368131, 126.9690727159189 37.55389693009717)))"
45,서울특별시,용산구,원효로1동,11170560,16471,7968,8503,"MULTIPOLYGON (((126.9708604054035 37.53913972358701, 126.9708604770798 37.53893015987028, 126.9708589929989 37.53823836650503, 126.9707716105247 37.5366819493632, 126.9706182363884 37.53626896409031, 126.970493698255 37.53599496104228, 126.9702675772768 37.5355361704873, 126.9694577528249 37.53431458408743, 126.9691872903213 37.53414774537988, 126.9688039498386 37.53402349377753, 126.9668000873193 37.53380799778225, 126.9667002875018 37.53406443225889, 126.9663758112458 37.53423196985558, 126.966028224308 37.53431602706641, 126.9650531861843 37.53454596375454, 126.9649639908927 37.53455457318435, 126.9648791365156 37.53454968194992, 126.9648163350352 37.53453943742436, 126.9647441840512 37.53452766235804, 126.9638200485198 37.53434144760607, 126.9637798104614 37.53433284177749, 126.9635702083233 37.5342846049701, 126.9633889777717 37.53420378668208, 126.9633286875682 37.53416854028311, 126.9632530234321 37.53412429969964, 126.9615863354054 37.53314550670364, 126.9606452339531 37.53553654629352, 126.9606974631578 37.53570360684, 126.9607157861052 37.5357622116199, 126.9610586941201 37.53608375661641, 126.9619673960104 37.53675726227117, 126.9631692346343 37.53742398892736, 126.9636992905088 37.53828718720153, 126.9638582447411 37.53861465035996, 126.9648841563662 37.54146982415098, 126.9707142905423 37.54160089942361, 126.9708604054035 37.53913972358701)))"
46,서울특별시,용산구,한강로동,11170625,19504,9520,9984,"MULTIPOLYGON (((126.9790263534719 37.53469515620201, 126.9792427328392 37.53277401117865, 126.9762303400895 37.521791225937, 126.9726300711119 37.52291992345089, 126.9725166446824 37.52295659773497, 126.9720605476721 37.52304018836505, 126.9701803036901 37.52287403080195, 126.9698926704379 37.52283156631118, 126.9696687524836 37.52279849992201, 126.9693606986032 37.52275204859384, 126.9678604745758 37.52245911901552, 126.9670136172901 37.52229080339814, 126.9663318825977 37.52215836629941, 126.9658875501367 37.52209981222692, 126.9654904016198 37.52205069448154, 126.9653835728586 37.52203789847504, 126.9651384706399 37.52200854033426, 126.9645685240047 37.52199018417411, 126.964436996044 37.52198620774411, 126.9639706290606 37.52202352622093, 126.9637873276632 37.52203846783005, 126.9632495712018 37.52216784799834, 126.9631964233534 37.52218112674079, 126.9622079258954 37.5224357687129, 126.9618154559879 37.52260191650202, 126.9617588321463 37.52262638707772, 126.9611359322327 37.52288944575371, 126.9604268523151 37.52323548255101, 126.9601961605454 37.52334822415668, 126.9593302399657 37.52386310430765, 126.9579619187673 37.52469903347836, 126.9575271130461 37.52496519033369, 126.9572036491524 37.52523823801911, 126.9570147073702 37.5253977380828, 126.9569780050919 37.52543061290714, 126.956885838974 37.52551319462444, 126.9566573295604 37.52572061009261, 126.9554478901703 37.52696676348369, 126.9546061925035 37.53152596903676, 126.9548437411843 37.53164311753441, 126.9551095525442 37.53176377332507, 126.9566707944698 37.53244021987122, 126.9574120688592 37.53274220058974, 126.9587392054552 37.53312460394796, 126.9596128642481 37.53330886440236, 126.9596750917351 37.53332155352994, 126.9614192735113 37.53316164434676, 126.9615863354054 37.53314550670364, 126.9632530234321 37.53412429969964, 126.9633286875682 37.53416854028311, 126.9633889777717 37.53420378668208, 126.9635702083233 37.5342846049701, 126.9637798104614 37.53433284177749, 126.9638200485198 37.53434144760607, 126.9647441840512 37.53452766235804, 126.9648163350352 37.53453943742436, 126.9648791365156 37.53454968194992, 126.9649639908927 37.53455457318435, 126.9650531861843 37.53454596375454, 126.966028224308 37.53431602706641, 126.9663758112458 37.53423196985558, 126.9667002875018 37.53406443225889, 126.9668000873193 37.53380799778225, 126.9688039498386 37.53402349377753, 126.9691872903213 37.53414774537988, 126.9694577528249 37.53431458408743, 126.9702675772768 37.5355361704873, 126.970493698255 37.53599496104228, 126.9706182363884 37.53626896409031, 126.9707716105247 37.5366819493632, 126.9708589929989 37.53823836650503, 126.9708604770798 37.53893015987028, 126.9708604054035 37.53913972358701, 126.9715574805063 37.53934641964027, 126.9732079511342 37.54031634100102, 126.9733833465178 37.53982137957513, 126.9738582297974 37.53798474070869, 126.9739137475633 37.53776919561428, 126.9750684972635 37.53537281654359, 126.97613392393 37.53456747065809, 126.9787837898104 37.53468397810137, 126.9790263534719 37.53469515620201)))"
47,서울특별시,용산구,한남동,11170685,23600,11728,11872,"MULTIPOLYGON (((127.0053057362477 37.547712171131, 127.0048426049037 37.5461822628338, 127.0072581374889 37.54381073731256, 127.0086060357027 37.5439797142403, 127.0085771761213 37.54388905249616, 127.0084251618494 37.54286466482799, 127.0083369603786 37.54185929062552, 127.009322759818 37.53967748124033, 127.0094711494728 37.53957682723549, 127.0099259813642 37.5393714047437, 127.0115330396057 37.53898146832435, 127.0117646889824 37.53904214089354, 127.0121256959346 37.53915070095481, 127.0121366075481 37.53918564909578, 127.012889891509 37.5393138132998, 127.0147892631177 37.53890137744123, 127.0157637398012 37.5383059781119, 127.0171942266706 37.53742400398112, 127.0209244123452 37.53511935680613, 127.020181900875 37.53464200517251, 127.0200593026991 37.53456262055563, 127.0195125720225 37.53410521396481, 127.018222147936 37.53302283940944, 127.0170382269451 37.53202891694836, 127.0163745366173 37.53147171975786, 127.0154570894157 37.53070180857035, 127.0126091764842 37.52831276912609, 127.0118681148712 37.5278410044609, 127.0079721761886 37.52458897654878, 127.007299455643 37.5251359980717, 127.0047913738895 37.52672879151885, 127.0042308771999 37.52698557917714, 127.0038915707817 37.52716555266758, 127.0028502450567 37.5281425215702, 127.0028546670898 37.52817198740478, 127.0028874330769 37.52838494390736, 127.0031618845765 37.52882886168496, 127.0033789212051 37.5290743477929, 127.0034519483255 37.5291410485523, 127.0036929856528 37.52927388469134, 127.0037270548527 37.5294656646028, 127.0036036475541 37.52993496735662, 127.0035445245662 37.53000899034082, 127.0033169624272 37.53019055753079, 127.0029936018478 37.53041678880711, 127.0009161688242 37.53167330201919, 126.9981005623741 37.53264273522102, 126.9978700030165 37.53261350853067, 126.9970362064646 37.53335138412458, 126.9951238370298 37.53821841191651, 126.9953415994772 37.53897197228811, 126.9953402543276 37.539171388778, 126.9953581609513 37.5392487201466, 126.9953739370821 37.53931684862134, 126.9953961362938 37.53939834454324, 126.9954160526438 37.53947141208202, 126.9955169520908 37.53961605942692, 126.9956583424044 37.53971013353474, 126.9958578356203 37.53984285311787, 126.9964973253067 37.54026694082628, 126.996935573597 37.54053923661548, 126.9973390465254 37.54071784500693, 126.997395445649 37.54076765038533, 126.9975415975371 37.54089672394787, 126.9975633376285 37.54092611037149, 126.9977809633374 37.54122203943294, 126.9978050580553 37.54125480687934, 126.9978431735476 37.54181731755035, 126.9978623988136 37.54221750912124, 126.9965053563669 37.54602099719253, 126.9953205558618 37.54723726999229, 126.9977430665264 37.54935788556125, 126.9985217771834 37.54993129931611, 126.998856340108 37.54990824810945, 126.9991043126989 37.54989093079555, 126.9993668863353 37.54979177549393, 126.9998071820105 37.5496188183286, 126.9998683866524 37.54959449776895, 126.9999506788974 37.54956217236035, 127.0002169569067 37.54951469894092, 127.0002531588077 37.5495082452712, 127.0026844109379 37.54960075852897, 127.0038924990723 37.55019622503125, 127.0042252789949 37.55037563944465, 127.0044022483744 37.5496644238298, 127.004378547336 37.54956281427435, 127.0043874011466 37.5491865376636, 127.0044701900094 37.54897281441067, 127.0046307895352 37.54856352705784, 127.0047155966243 37.54834740546745, 127.0053201488406 37.54830036548167, 127.0054215005781 37.54828528681733, 127.0055411191471 37.5482674903744, 127.0057366184737 37.5482345082359, 127.0057835896978 37.54822566429836, 127.0058944050891 37.54820461733567, 127.0053134550067 37.54781352249104, 127.0053100902793 37.54777022103047, 127.0053075969663 37.54773809546151, 127.0053057362477 37.547712171131)))"
48,서울특별시,성동구,왕십리2동,11200520,17953,8738,9215,"MULTIPOLYGON (((127.0335105890943 37.56251785612066, 127.0310651246286 37.5603336203399, 127.0305805092712 37.5603092040505, 127.0303669216555 37.56040299634883, 127.03024780478 37.56043970313927, 127.0281959521155 37.56027040521961, 127.0280857666518 37.5602372909303, 127.0270704014286 37.55977128643338, 127.0267783799765 37.55961005467637, 127.0267478281066 37.55959100387534, 127.0267129013904 37.55956817690134, 127.0243104032299 37.55789775336096, 127.0228571463334 37.55786826039839, 127.0233348751008 37.56074436830169, 127.0234949744223 37.56071797409027, 127.0235298861134 37.56073011014464, 127.0262652068204 37.56299376211291, 127.0263954842566 37.5632072285016, 127.0264815834279 37.56335578267504, 127.0264991149577 37.56338741823071, 127.0265912494255 37.56358432685774, 127.0267075541278 37.5638822383187, 127.0267568039915 37.56428904775203, 127.0267054954105 37.56498976245136, 127.0274181939417 37.56487093628703, 127.0335105890943 37.56251785612066)))"
49,서울특별시,성동구,마장동,11200540,24137,11834,12303,"MULTIPOLYGON (((127.048231226469 37.5653839308235, 127.0473688798568 37.56535133754722, 127.046998846571 37.56533527135878, 127.0468986004312 37.56532837171225, 127.0468875505915 37.56528584690483, 127.0468041360957 37.56494950187192, 127.0467203089956 37.56435172236407, 127.0464033363089 37.563756749957, 127.0462359804167 37.56346204153842, 127.0456906942649 37.56258559474328, 127.0455384999486 37.5623653455513, 127.0453172335883 37.56221691561765, 127.0452882885652 37.56219763243105, 127.0451688438625 37.56217351100296, 127.0415086112868 37.56196556320779, 127.0393822262425 37.56193700598411, 127.0391946872157 37.56204331032875, 127.0388260791376 37.5628485788996, 127.0388233363301 37.56289934120178, 127.0364958099469 37.56603810543127, 127.0348009146281 37.56623650578948, 127.034718758916 37.56624632220725, 127.0330359943372 37.5679195667875, 127.0323108119812 37.57014415410847, 127.0347616574307 37.57175260339242, 127.0351015240643 37.57195787228406, 127.0354515110276 37.57212938037326, 127.0363730939317 37.57245974195402, 127.0364781687079 37.57249708189399, 127.036533410708 37.57251670570779, 127.0379274804577 37.57289848242191, 127.0379847878536 37.57290321345877, 127.0386504761305 37.57295539101556, 127.0421804638618 37.57302096202505, 127.0428947081306 37.57207956673216, 127.0438401612394 37.57093963901143, 127.0452883281562 37.57010809842657, 127.0458753950106 37.56968705782185, 127.0459820437794 37.56961056855876, 127.0460092723983 37.56956668294923, 127.0466232863217 37.56856741965763, 127.0467297900946 37.5683931913745, 127.0477648288262 37.5665831958161, 127.048231226469 37.5653839308235)))"
50,서울특별시,성동구,사근동,11200550,13630,6748,6882,"MULTIPOLYGON (((127.049335021649 37.55263967734592, 127.0480047483539 37.55287683059181, 127.0479340172985 37.55288444482586, 127.0470070983177 37.55298223842147, 127.0469071972007 37.55299270286498, 127.0466941638218 37.55301489667452, 127.0466403542758 37.55302032352131, 127.0444971677987 37.55300531481577, 127.0417608854932 37.55270414946288, 127.0398347700454 37.55291511357612, 127.0390152497448 37.55385602422403, 127.0391433139045 37.5540785539062, 127.0392042269875 37.55418470036806, 127.0393517040898 37.5544804682189, 127.0394610618692 37.5548774891508, 127.0395015881118 37.55507707106097, 127.0395317932061 37.55522815158125, 127.0395344311283 37.55537351818228, 127.0395391615645 37.55564322975051, 127.0395406622637 37.55574084285904, 127.0395173129059 37.55608551838618, 127.0391666499066 37.5608601794038, 127.0388260791376 37.5628485788996, 127.0391946872157 37.56204331032875, 127.0393822262425 37.56193700598411, 127.0415086112868 37.56196556320779, 127.0451688438625 37.56217351100296, 127.0452882885652 37.56219763243105, 127.0453172335883 37.56221691561765, 127.0455384999486 37.5623653455513, 127.0456906942649 37.56258559474328, 127.0462359804167 37.56346204153842, 127.0464033363089 37.563756749957, 127.0467203089956 37.56435172236407, 127.0468041360957 37.56494950187192, 127.0468875505915 37.56528584690483, 127.0468986004312 37.56532837171225, 127.046998846571 37.56533527135878, 127.0473688798568 37.56535133754722, 127.048231226469 37.5653839308235, 127.0485963819654 37.56494254326073, 127.0497864022829 37.56311622083041, 127.0500039998498 37.56270693533357, 127.0503865525854 37.56181605727264, 127.0504297295118 37.56169679191323, 127.0507506323413 37.56080392820351, 127.0516575379281 37.55827182284622, 127.0516744025048 37.55688946278211, 127.0511577283879 37.55500478046029, 127.0506054281733 37.55400443323168, 127.05047748758 37.55386423676677, 127.0497822380598 37.55310670608544, 127.049335021649 37.55263967734592)))"
51,서울특별시,성동구,행당1동,11200560,16659,8068,8591,"MULTIPOLYGON (((127.0388260791376 37.5628485788996, 127.0391666499066 37.5608601794038, 127.0395173129059 37.55608551838618, 127.0395406622637 37.55574084285904, 127.0395391615645 37.55564322975051, 127.0395344311283 37.55537351818228, 127.0395317932061 37.55522815158125, 127.0395015881118 37.55507707106097, 127.0394610618692 37.5548774891508, 127.0393517040898 37.5544804682189, 127.0392042269875 37.55418470036806, 127.0391433139045 37.5540785539062, 127.0390152497448 37.55385602422403, 127.0342300750311 37.55459670372491, 127.0342800962612 37.55485831884376, 127.034084733576 37.55736890936597, 127.0339799865345 37.55850820355963, 127.0334485249428 37.55839844378799, 127.0328075063359 37.55826972000776, 127.0307685276872 37.55786166099139, 127.0307070871147 37.55813153244614, 127.0306506431727 37.55837946863793, 127.0306295412555 37.55847289889896, 127.0310651246286 37.5603336203399, 127.0335105890943 37.56251785612066, 127.0344646629711 37.56190094378163, 127.0344961078788 37.56188066121586, 127.0354530618122 37.5612805262498, 127.0355924069025 37.56151993299568, 127.0357975551999 37.56198831485672, 127.03585470922 37.56212937542273, 127.0359850228641 37.56245437346963, 127.0361472637802 37.56345212875694, 127.0361669161164 37.56359181235435, 127.0362082439404 37.56388952272411, 127.03629428317 37.56450953826185, 127.0363213263698 37.56471357471787, 127.0364958099469 37.56603810543127, 127.0388233363301 37.56289934120178, 127.0388260791376 37.5628485788996)))"
52,서울특별시,성동구,행당2동,11200570,24748,11628,13120,"MULTIPOLYGON (((127.0310651246286 37.5603336203399, 127.0306295412555 37.55847289889896, 127.0306506431727 37.55837946863793, 127.0307070871147 37.55813153244614, 127.0307685276872 37.55786166099139, 127.0328075063359 37.55826972000776, 127.0334485249428 37.55839844378799, 127.0339799865345 37.55850820355963, 127.034084733576 37.55736890936597, 127.0342800962612 37.55485831884376, 127.0342077605319 37.55477125327055, 127.0340753841892 37.55461359852337, 127.0339970420137 37.55452029700808, 127.0319409587752 37.55295880619362, 127.0317200209378 37.55293054441317, 127.0313578302582 37.55291558713589, 127.0295103782177 37.55391100332733, 127.0292998660219 37.55386396016431, 127.0291002582485 37.55387443022619, 127.0281016914397 37.55412169580781, 127.0259292272262 37.55492646174494, 127.0258880658178 37.55494545016129, 127.0257377062803 37.55501577354698, 127.0249025418564 37.55569862190944, 127.0248768467021 37.55573344582895, 127.0243104032299 37.55789775336096, 127.0267129013904 37.55956817690134, 127.0267478281066 37.55959100387534, 127.0267783799765 37.55961005467637, 127.0270704014286 37.55977128643338, 127.0280857666518 37.5602372909303, 127.0281959521155 37.56027040521961, 127.03024780478 37.56043970313927, 127.0303669216555 37.56040299634883, 127.0305805092712 37.5603092040505, 127.0310651246286 37.5603336203399)))"
53,서울특별시,성동구,응봉동,11200580,16228,7699,8529,"MULTIPOLYGON (((127.0390152497448 37.55385602422403, 127.0398347700454 37.55291511357612, 127.0400513317907 37.55277151137265, 127.0404647848349 37.55249730329997, 127.0400616802418 37.55133075987253, 127.0343762648813 37.54815938023606, 127.0324952299345 37.5467480925071, 127.0323614517735 37.54671708356258, 127.0312213542888 37.54656823300262, 127.0303982788621 37.54627106956995, 127.0295349333434 37.54920292813809, 127.0289760272449 37.54910353424354, 127.0295103782177 37.55391100332733, 127.0313578302582 37.55291558713589, 127.0317200209378 37.55293054441317, 127.0319409587752 37.55295880619362, 127.0339970420137 37.55452029700808, 127.0340753841892 37.55461359852337, 127.0342077605319 37.55477125327055, 127.0342800962612 37.55485831884376, 127.0342300750311 37.55459670372491, 127.0390152497448 37.55385602422403)))"
54,서울특별시,성동구,금호1가동,11200590,15974,7641,8333,"MULTIPOLYGON (((127.0295103782177 37.55391100332733, 127.0289760272449 37.54910353424354, 127.0258687582335 37.54831931697688, 127.0260685667201 37.54934765947889, 127.026070868967 37.54943104369674, 127.0260830748464 37.54996176312311, 127.0259317797021 37.55038929749342, 127.0254866672961 37.55162574025871, 127.0253038951838 37.55199568607598, 127.0252443973734 37.55211600251171, 127.0247847175042 37.55252314115462, 127.0244498593737 37.55266150229367, 127.0242647590085 37.55273752466378, 127.0241171459116 37.55279711298763, 127.0234297684625 37.55306750383997, 127.0233999787897 37.55307865137951, 127.0233227158448 37.55310087324295, 127.0230760364234 37.55316973085738, 127.0227379161554 37.5532630064122, 127.0199825038041 37.5556990012326, 127.0194639028375 37.5573396016988, 127.0193708860018 37.55749921354852, 127.021824292577 37.55770941022003, 127.0228571463334 37.55786826039839, 127.0243104032299 37.55789775336096, 127.0248768467021 37.55573344582895, 127.0249025418564 37.55569862190944, 127.0257377062803 37.55501577354698, 127.0258880658178 37.55494545016129, 127.0259292272262 37.55492646174494, 127.0281016914397 37.55412169580781, 127.0291002582485 37.55387443022619, 127.0292998660219 37.55386396016431, 127.0295103782177 37.55391100332733)))"
55,서울특별시,성동구,금호4가동,11200620,15283,7320,7963,"MULTIPOLYGON (((127.0303982788621 37.54627106956995, 127.0307485848787 37.54614514627833, 127.0309124776693 37.54605535584055, 127.0310936249002 37.54595610640448, 127.0309984917606 37.5456285919558, 127.0308927768987 37.54526464780066, 127.028283460348 37.5385279110979, 127.0256997843901 37.53786411011562, 127.0250259665248 37.53872004668482, 127.0228747664207 37.54145247733586, 127.0226878964738 37.54168945377219, 127.0212955204793 37.54335695204102, 127.0197115820878 37.54514917644688, 127.0168257851031 37.54573408804654, 127.0151905740526 37.54706701878207, 127.0144537203588 37.54809716556332, 127.0148769335965 37.54829945567298, 127.0167932765557 37.54846955751904, 127.0192395050558 37.5483206797438, 127.0254157372199 37.54808201901932, 127.0258687582335 37.54831931697688, 127.0289760272449 37.54910353424354, 127.0295349333434 37.54920292813809, 127.0303982788621 37.54627106956995)))"
56,서울특별시,성동구,성수1가1동,11200650,17331,8681,8650,"MULTIPOLYGON (((127.0495848092956 37.54417130147216, 127.0518827143569 37.54347360992696, 127.0511622391583 37.54221686631605, 127.0511231793253 37.54214622302343, 127.0510698384373 37.54204973771432, 127.0510517094048 37.54200979293182, 127.0510091151417 37.54191320423435, 127.0506465657996 37.54078738712695, 127.0506264541866 37.54072083579391, 127.050574631593 37.5405476238179, 127.0505515503896 37.54047042519918, 127.0504567814978 37.54011064983612, 127.0504497705772 37.54006421246353, 127.0504432757023 37.5400204360471, 127.0508350969403 37.53729975821339, 127.0504482232005 37.53670575411557, 127.0497573583354 37.5346559218743, 127.0490584255916 37.53255215318233, 127.0459616923422 37.53250292666626, 127.0391850762318 37.53522693434535, 127.0380050046339 37.53570116771692, 127.0378156485108 37.53577704182295, 127.0348628173433 37.53692256055055, 127.0298568459488 37.53886430616576, 127.0283265484259 37.5385393501206, 127.028283460348 37.5385279110979, 127.0308927768987 37.54526464780066, 127.0309984917606 37.5456285919558, 127.0310936249002 37.54595610640448, 127.0309124776693 37.54605535584055, 127.0307485848787 37.54614514627833, 127.0303982788621 37.54627106956995, 127.0312213542888 37.54656823300262, 127.0311645405379 37.54628426371614, 127.0311212264002 37.54606775829292, 127.0343606790148 37.54543273055106, 127.0355855964052 37.54631073924196, 127.0364073608876 37.54717250606667, 127.0364986472096 37.547284406716, 127.0367191268212 37.54755680418899, 127.039183277382 37.54689831949639, 127.0435883982553 37.54596337558451, 127.0438010540214 37.54598810753401, 127.0439693579714 37.54622672454543, 127.0447598890414 37.54621411307203, 127.0453919258924 37.5461382575516, 127.0467759478108 37.54570299420386, 127.047355959806 37.54548777226, 127.0491168927087 37.54481381067335, 127.0495848092956 37.54417130147216)))"
57,서울특별시,성동구,성수1가2동,11200660,15084,7494,7590,"MULTIPOLYGON (((127.049335021649 37.55263967734592, 127.0525163498266 37.5516884576043, 127.0521825149442 37.55083769683421, 127.0495848092956 37.54417130147216, 127.0491168927087 37.54481381067335, 127.047355959806 37.54548777226, 127.0467759478108 37.54570299420386, 127.0453919258924 37.5461382575516, 127.0447598890414 37.54621411307203, 127.0439693579714 37.54622672454543, 127.0438010540214 37.54598810753401, 127.0435883982553 37.54596337558451, 127.039183277382 37.54689831949639, 127.0367191268212 37.54755680418899, 127.0364986472096 37.547284406716, 127.0364073608876 37.54717250606667, 127.0355855964052 37.54631073924196, 127.0343606790148 37.54543273055106, 127.0311212264002 37.54606775829292, 127.0311645405379 37.54628426371614, 127.0312213542888 37.54656823300262, 127.0323614517735 37.54671708356258, 127.0324952299345 37.5467480925071, 127.0343762648813 37.54815938023606, 127.0400616802418 37.55133075987253, 127.0404647848349 37.55249730329997, 127.0400513317907 37.55277151137265, 127.0398347700454 37.55291511357612, 127.0417608854932 37.55270414946288, 127.0444971677987 37.55300531481577, 127.0466403542758 37.55302032352131, 127.0466941638218 37.55301489667452, 127.0469071972007 37.55299270286498, 127.0470070983177 37.55298223842147, 127.0479340172985 37.55288444482586, 127.0480047483539 37.55287683059181, 127.049335021649 37.55263967734592)))"
58,서울특별시,성동구,성수2가1동,11200670,17979,9354,8625,"MULTIPOLYGON (((127.0628263118332 37.54018625021281, 127.0565665637636 37.52910117290874, 127.0490584255916 37.53255215318233, 127.0497573583354 37.5346559218743, 127.0504482232005 37.53670575411557, 127.0508350969403 37.53729975821339, 127.0504432757023 37.5400204360471, 127.0504497705772 37.54006421246353, 127.0504567814978 37.54011064983612, 127.0505515503896 37.54047042519918, 127.050574631593 37.5405476238179, 127.0506264541866 37.54072083579391, 127.0506465657996 37.54078738712695, 127.0510091151417 37.54191320423435, 127.0510517094048 37.54200979293182, 127.0510698384373 37.54204973771432, 127.0511231793253 37.54214622302343, 127.0511622391583 37.54221686631605, 127.0518827143569 37.54347360992696, 127.0628263118332 37.54018625021281)))"
59,서울특별시,성동구,성수2가3동,11200690,11725,5983,5742,"MULTIPOLYGON (((127.0674989599414 37.54831126401997, 127.0639433937799 37.54215094444825, 127.0628263118332 37.54018625021281, 127.0518827143569 37.54347360992696, 127.0495848092956 37.54417130147216, 127.0521825149442 37.55083769683421, 127.0545813523928 37.55009185937717, 127.0560877986929 37.54948686654708, 127.0564303134735 37.54935858438053, 127.0566870159959 37.54926265308308, 127.0572606805191 37.54904960765292, 127.0573711705647 37.54900919965196, 127.0582940274043 37.54874815549424, 127.0586540990725 37.54864696226985, 127.0592522842183 37.5485090814124, 127.0600441892581 37.54832653637905, 127.0611253118993 37.54820775220593, 127.0620555267755 37.54812107073568, 127.0622537462283 37.5481026511114, 127.0631071240608 37.5480889068532, 127.0665851339374 37.54825608641141, 127.0674989599414 37.54831126401997)))"
60,서울특별시,성동구,송정동,11200720,11546,6131,5415,"MULTIPOLYGON (((127.0736980512022 37.55943959028697, 127.0674989599414 37.54831126401997, 127.0665851339374 37.54825608641141, 127.0631071240608 37.5480889068532, 127.0622537462283 37.5481026511114, 127.0620555267755 37.54812107073568, 127.0611253118993 37.54820775220593, 127.0600441892581 37.54832653637905, 127.0592522842183 37.5485090814124, 127.0586540990725 37.54864696226985, 127.0582940274043 37.54874815549424, 127.0573711705647 37.54900919965196, 127.0572606805191 37.54904960765292, 127.0566870159959 37.54926265308308, 127.0564303134735 37.54935858438053, 127.0560877986929 37.54948686654708, 127.0545813523928 37.55009185937717, 127.0521825149442 37.55083769683421, 127.0525163498266 37.5516884576043, 127.053924017412 37.55139971807555, 127.0542577636833 37.55131254685215, 127.0547744260228 37.5511775898491, 127.0567157408788 37.55062492917001, 127.0586048437545 37.55004049395345, 127.0587528491603 37.54999522239913, 127.0596638439424 37.54971658115313, 127.0597956321776 37.54968552522511, 127.0598535524578 37.54967258230506, 127.060475070174 37.54965425649843, 127.0609872703335 37.5496663022009, 127.0613591728397 37.54971275197306, 127.06219220644 37.54981839410979, 127.0624161891382 37.54984737001322, 127.0629520112523 37.55005441215235, 127.0632130467768 37.55018494744219, 127.0633775437831 37.55026786281073, 127.0634335079133 37.55029621446428, 127.0635432126281 37.5503517917959, 127.0639058527031 37.55065395799113, 127.0640825826687 37.55080220609555, 127.0649502396359 37.5518678749272, 127.0653977931447 37.55265708027173, 127.0655455738949 37.5529178894797, 127.0664205559591 37.55407145598664, 127.0683763165356 37.55640861460552, 127.0687164548382 37.55673581325583, 127.0687621123569 37.55677973162045, 127.0692609054427 37.55725911535126, 127.0693571336964 37.55735121492223, 127.0695114417844 37.55749888718865, 127.0718049195418 37.5594540763446, 127.0736980512022 37.55943959028697)))"
61,서울특별시,성동구,용답동,11200790,13572,7149,6423,"MULTIPOLYGON (((127.0568373842199 37.56376600874093, 127.0577746000723 37.56301909685816, 127.0581434085977 37.56276133867567, 127.058203099727 37.56271987461578, 127.0587070964176 37.56245811550777, 127.0590533052705 37.56231181295948, 127.0593885097285 37.56223137955729, 127.0633071391025 37.56148372542138, 127.0655041845152 37.56114736134133, 127.0655457134635 37.56134570763972, 127.0689163529316 37.56086882865115, 127.0696908565203 37.56075341933541, 127.0707073251638 37.56058360964267, 127.0721016615051 37.56004560739462, 127.0736980512022 37.55943959028697, 127.0718049195418 37.5594540763446, 127.0695114417844 37.55749888718865, 127.0693571336964 37.55735121492223, 127.0692609054427 37.55725911535126, 127.0687621123569 37.55677973162045, 127.0687164548382 37.55673581325583, 127.0683763165356 37.55640861460552, 127.0664205559591 37.55407145598664, 127.0655455738949 37.5529178894797, 127.0653977931447 37.55265708027173, 127.0649502396359 37.5518678749272, 127.0640825826687 37.55080220609555, 127.0639058527031 37.55065395799113, 127.0635432126281 37.5503517917959, 127.0634335079133 37.55029621446428, 127.0633775437831 37.55026786281073, 127.0632130467768 37.55018494744219, 127.0629520112523 37.55005441215235, 127.0624161891382 37.54984737001322, 127.06219220644 37.54981839410979, 127.0613591728397 37.54971275197306, 127.0609872703335 37.5496663022009, 127.060475070174 37.54965425649843, 127.0598535524578 37.54967258230506, 127.0597956321776 37.54968552522511, 127.0596638439424 37.54971658115313, 127.0587528491603 37.54999522239913, 127.0586048437545 37.55004049395345, 127.0567157408788 37.55062492917001, 127.0547744260228 37.5511775898491, 127.0542577636833 37.55131254685215, 127.053924017412 37.55139971807555, 127.0525163498266 37.5516884576043, 127.049335021649 37.55263967734592, 127.0497822380598 37.55310670608544, 127.05047748758 37.55386423676677, 127.0506054281733 37.55400443323168, 127.0511577283879 37.55500478046029, 127.0516744025048 37.55688946278211, 127.0516575379281 37.55827182284622, 127.0507506323413 37.56080392820351, 127.0504297295118 37.56169679191323, 127.0503865525854 37.56181605727264, 127.0500039998498 37.56270693533357, 127.0497864022829 37.56311622083041, 127.0485963819654 37.56494254326073, 127.048231226469 37.5653839308235, 127.0477648288262 37.5665831958161, 127.0467297900946 37.5683931913745, 127.0466232863217 37.56856741965763, 127.0460092723983 37.56956668294923, 127.0459820437794 37.56961056855876, 127.0458753950106 37.56968705782185, 127.0452883281562 37.57010809842657, 127.0438401612394 37.57093963901143, 127.0428947081306 37.57207956673216, 127.0421804638618 37.57302096202505, 127.0486572587522 37.56986639461969, 127.0568373842199 37.56376600874093)))"
62,서울특별시,성동구,왕십리도선동,11200535,27878,13290,14588,"MULTIPOLYGON (((127.0323108119812 37.57014415410847, 127.0330359943372 37.5679195667875, 127.034718758916 37.56624632220725, 127.0348009146281 37.56623650578948, 127.0364958099469 37.56603810543127, 127.0363213263698 37.56471357471787, 127.03629428317 37.56450953826185, 127.0362082439404 37.56388952272411, 127.0361669161164 37.56359181235435, 127.0361472637802 37.56345212875694, 127.0359850228641 37.56245437346963, 127.03585470922 37.56212937542273, 127.0357975551999 37.56198831485672, 127.0355924069025 37.56151993299568, 127.0354530618122 37.5612805262498, 127.0344961078788 37.56188066121586, 127.0344646629711 37.56190094378163, 127.0335105890943 37.56251785612066, 127.0274181939417 37.56487093628703, 127.0267054954105 37.56498976245136, 127.0236152478631 37.56516886904607, 127.0235977494824 37.56580425008264, 127.0233681239995 37.5717398548992, 127.0303570854259 37.56981928565613, 127.0323108119812 37.57014415410847)))"
63,서울특별시,성동구,금호2.3가동,11200615,24299,11593,12706,"MULTIPOLYGON (((127.0258687582335 37.54831931697688, 127.0254157372199 37.54808201901932, 127.0192395050558 37.5483206797438, 127.0167932765557 37.54846955751904, 127.0148769335965 37.54829945567298, 127.0144537203588 37.54809716556332, 127.0143741212569 37.54913421189207, 127.0132076195527 37.54994422861261, 127.016306137489 37.55301149563815, 127.0174114356653 37.55598265791892, 127.0178802397968 37.55657037839764, 127.0179241335154 37.5566004734223, 127.0180042334842 37.55665538618447, 127.0183658575566 37.55686980577583, 127.0185886851535 37.55699127006635, 127.01876860869 37.5570731250229, 127.0189069084919 37.55713452973983, 127.0194639028375 37.5573396016988, 127.0199825038041 37.5556990012326, 127.0227379161554 37.5532630064122, 127.0230760364234 37.55316973085738, 127.0233227158448 37.55310087324295, 127.0233999787897 37.55307865137951, 127.0234297684625 37.55306750383997, 127.0241171459116 37.55279711298763, 127.0242647590085 37.55273752466378, 127.0244498593737 37.55266150229367, 127.0247847175042 37.55252314115462, 127.0252443973734 37.55211600251171, 127.0253038951838 37.55199568607598, 127.0254866672961 37.55162574025871, 127.0259317797021 37.55038929749342, 127.0260830748464 37.54996176312311, 127.026070868967 37.54943104369674, 127.0260685667201 37.54934765947889, 127.0258687582335 37.54831931697688)))"
64,서울특별시,성동구,옥수동,11200645,27264,12783,14481,"MULTIPOLYGON (((127.0144537203588 37.54809716556332, 127.0151905740526 37.54706701878207, 127.0168257851031 37.54573408804654, 127.0197115820878 37.54514917644688, 127.0212955204793 37.54335695204102, 127.0226878964738 37.54168945377219, 127.0228747664207 37.54145247733586, 127.0250259665248 37.53872004668482, 127.0256997843901 37.53786411011562, 127.0215649184989 37.5355309658779, 127.0209244123452 37.53511935680613, 127.0171942266706 37.53742400398112, 127.0157637398012 37.5383059781119, 127.0147892631177 37.53890137744123, 127.012889891509 37.5393138132998, 127.0121366075481 37.53918564909578, 127.0121256959346 37.53915070095481, 127.0117646889824 37.53904214089354, 127.0115330396057 37.53898146832435, 127.0099259813642 37.5393714047437, 127.0094711494728 37.53957682723549, 127.009322759818 37.53967748124033, 127.0083369603786 37.54185929062552, 127.0084251618494 37.54286466482799, 127.0085771761213 37.54388905249616, 127.0086060357027 37.5439797142403, 127.0106819407089 37.54807821534514, 127.0107823571481 37.54808651825122, 127.0108132431098 37.54809814744943, 127.0108670535388 37.54811841641107, 127.0114799688542 37.54841614618272, 127.0116576475451 37.54851152298635, 127.0132076195527 37.54994422861261, 127.0143741212569 37.54913421189207, 127.0144537203588 37.54809716556332)))"
65,서울특별시,광진구,화양동,11215710,25422,11618,13804,"MULTIPOLYGON (((127.0740568206921 37.54734047383357, 127.0770234179925 37.54602140223154, 127.077276571686 37.5459197798487, 127.0773314204087 37.54589843384859, 127.078321553062 37.54567451735506, 127.0787904918886 37.54557478879624, 127.0794790149448 37.54542964621464, 127.0799211014065 37.54538195180461, 127.0800021572363 37.54537742690876, 127.0805003967054 37.54535103072671, 127.0808521419007 37.54533447809324, 127.0816136180864 37.54529864575228, 127.0823767315261 37.54497122551575, 127.0819175076054 37.54409303407575, 127.081770501862 37.54381196715663, 127.0815149775802 37.54332545752192, 127.0813719125099 37.54311959047246, 127.0813472430542 37.54308375081293, 127.0812995271387 37.54290202192861, 127.0812758854878 37.54281196495609, 127.0812766988486 37.5426665343926, 127.0812795590498 37.54215511631794, 127.0813110767247 37.54212009329554, 127.0814049050894 37.54201583733277, 127.0824739408193 37.54149572445384, 127.0829344891279 37.54137228907479, 127.0822903619827 37.54003782342225, 127.0799481177514 37.53900248300937, 127.0789410400282 37.53893460102604, 127.0784788462719 37.53902187973175, 127.0767803184492 37.53921193022391, 127.0752642196528 37.5393269348552, 127.0751353877829 37.53871142962469, 127.0732732417561 37.53907450660557, 127.0705546653783 37.53983166852371, 127.0639433937799 37.54215094444825, 127.0674989599414 37.54831126401997, 127.0716978673025 37.54788152546347, 127.0740568206921 37.54734047383357)))"
66,서울특별시,광진구,군자동,11215730,22142,10877,11265,"MULTIPOLYGON (((127.0779306730366 37.55777828455584, 127.0786614157165 37.55739392180736, 127.079144132767 37.55703636469454, 127.0791535763305 37.55699532105757, 127.0791996834301 37.55663424437545, 127.0761597913704 37.55059943235337, 127.0761402132226 37.55056416335719, 127.0761240642855 37.5505350827356, 127.0751880331766 37.54889117679154, 127.0742542405319 37.54759712408184, 127.0740568206921 37.54734047383357, 127.0716978673025 37.54788152546347, 127.0674989599414 37.54831126401997, 127.0736980512022 37.55943959028697, 127.0779306730366 37.55777828455584)))"
67,서울특별시,광진구,중곡1동,11215740,16420,8043,8377,"MULTIPOLYGON (((127.0833585138557 37.56420616005679, 127.0801427221809 37.55835235722529, 127.0798590783885 37.55779731630052, 127.078262836324 37.55776340581784, 127.0779306730366 37.55777828455584, 127.0736980512022 37.55943959028697, 127.0721016615051 37.56004560739462, 127.0758481256997 37.56663673099033, 127.0833585138557 37.56420616005679)))"
68,서울특별시,광진구,중곡2동,11215750,22635,10859,11776,"MULTIPOLYGON (((127.0869183946304 37.56350659316984, 127.0886731878298 37.55329248576748, 127.0886418495666 37.55332284681184, 127.0882901361815 37.55358639322325, 127.0874122248515 37.55406217219517, 127.0852124069335 37.55493666318063, 127.0831025057623 37.5557676247432, 127.0813815322039 37.55643516176124, 127.0800924470351 37.55693476613206, 127.0796302140462 37.55723033119941, 127.0798590783885 37.55779731630052, 127.0801427221809 37.55835235722529, 127.0833585138557 37.56420616005679, 127.0853914550931 37.56348886519989, 127.0869183946304 37.56350659316984)))"
69,서울특별시,광진구,중곡3동,11215760,17492,8650,8842,"MULTIPOLYGON (((127.0861650572925 37.5708206831413, 127.0861129331949 37.57007688682545, 127.0860763612628 37.56926779705231, 127.0860682948869 37.56880808026327, 127.0860659991302 37.56866226081475, 127.0860646257996 37.56857484306909, 127.0861548541763 37.56800167537831, 127.0867438249367 37.56451663985529, 127.0868827395906 37.56371041707236, 127.0869183946304 37.56350659316984, 127.0853914550931 37.56348886519989, 127.0833585138557 37.56420616005679, 127.0758481256997 37.56663673099033, 127.0768591693201 37.56843855225527, 127.0777770417743 37.57007891500324, 127.078200348487 37.57094459708917, 127.0785759598423 37.57186080820366, 127.0809830632769 37.57161023856756, 127.0861650572925 37.5708206831413)))"
70,서울특별시,광진구,중곡4동,11215770,30561,15040,15521,"MULTIPOLYGON (((127.1011460799232 37.56002336317411, 127.100897198902 37.55958423889474, 127.1003390803559 37.55901449924623, 127.0994576815695 37.55822564611957, 127.0976713000841 37.55742694586986, 127.0961391577987 37.55718623678302, 127.0928145428546 37.55448878831494, 127.0909072583408 37.55279779740976, 127.0902850237825 37.55258783755244, 127.0896283118283 37.55239905986659, 127.0886731878298 37.55329248576748, 127.0869183946304 37.56350659316984, 127.0868827395906 37.56371041707236, 127.0867438249367 37.56451663985529, 127.0861548541763 37.56800167537831, 127.0860646257996 37.56857484306909, 127.0860659991302 37.56866226081475, 127.0860682948869 37.56880808026327, 127.0860763612628 37.56926779705231, 127.0861129331949 37.57007688682545, 127.0861650572925 37.5708206831413, 127.0867166884517 37.57083838920319, 127.0868348759832 37.57083880289541, 127.086884128424 37.57083810545645, 127.0869572709058 37.57083810450286, 127.0870047406904 37.57083827057898, 127.0870368457857 37.5708380493905, 127.0871275432726 37.57083757343601, 127.087183126323 37.57083946505647, 127.0872305041583 37.57084131354029, 127.0875468475305 37.57084467257016, 127.0875900255644 37.57084482341646, 127.0878993722397 37.57083351012508, 127.0880098050867 37.57082938882181, 127.0880545551454 37.57082785044667, 127.0881601135496 37.57081847785512, 127.0882963490671 37.57038941207422, 127.0883258843631 37.57029643537405, 127.0883958317061 37.57007586386644, 127.0887108167531 37.57012652689168, 127.0887612248065 37.57013593682696, 127.0889222015686 37.57016782389041, 127.0889829636187 37.57018148990462, 127.0890858081777 37.57018131702684, 127.0891850045097 37.57015633612885, 127.0893103139441 37.57011960045174, 127.0895815164996 37.56996618742136, 127.0897688098207 37.56988459021333, 127.0898587688577 37.56980379930632, 127.089902524972 37.5697644992237, 127.0899995242394 37.569699744245, 127.0900990668529 37.56967504680114, 127.0902320795785 37.56964580006434, 127.0903513283238 37.56961958803458, 127.0904610890525 37.56960757528743, 127.0907209989502 37.56957805607605, 127.0907657501371 37.56957616514827, 127.0911704143874 37.56955933289674, 127.0912116349021 37.56956280161948, 127.0914584312257 37.56958511708553, 127.0918034663821 37.56964827842779, 127.0919503380712 37.56970843751996, 127.0920753356982 37.56975963353647, 127.092226723634 37.56982855098566, 127.0923121613131 37.56987102744539, 127.0924019599979 37.56995567864796, 127.092486120977 37.57009680513882, 127.0925334194428 37.57024681784164, 127.0926316243867 37.57041052644528, 127.0926920006641 37.57039662864189, 127.0927811420569 37.57037611497638, 127.0929231894347 37.57035558538936, 127.0930857153759 37.57033209768312, 127.0932297338196 37.57031974075185, 127.0933130156736 37.5703126005555, 127.0934530500668 37.57033110987896, 127.0936544502246 37.57038701096331, 127.0938041459436 37.57040521061167, 127.0939310048473 37.57042063648465, 127.0939783173292 37.57042887531118, 127.0940940190904 37.57044903077771, 127.0941883839337 37.57046546231959, 127.0942797039115 37.57050149219167, 127.0943190353236 37.57051661230069, 127.0944283363755 37.5705539972838, 127.0945719425608 37.57060310937155, 127.0947721133125 37.5707282018701, 127.0949572186979 37.5708169882403, 127.0950984055758 37.57088433471073, 127.0951467047176 37.57090493396179, 127.0953088319397 37.57097406455625, 127.0954432496255 37.57103056670222, 127.0955077303121 37.57105132491201, 127.0956502566457 37.57109563049658, 127.095751117705 37.57110356167774, 127.1009302111809 37.57355979582311, 127.1016369706142 37.57255829098158, 127.1029331801489 37.57237226212109, 127.1029742660925 37.57236564018081, 127.103076368838 37.57233105530796, 127.1031629187191 37.57229303980609, 127.1032630537128 37.57222802759305, 127.1036857039582 37.57194101521169, 127.1038347575378 37.57183457572422, 127.1039741802856 37.5717290402408, 127.103995532205 37.5717065781139, 127.1040119718996 37.57167508600468, 127.1041868020995 37.57109934450202, 127.1041900958462 37.57105149835515, 127.1041835025852 37.57099528607565, 127.1041596407065 37.57092182714482, 127.1040661489758 37.57079983134133, 127.1039825056977 37.5706913887536, 127.1039451686028 37.57065746196209, 127.10390080123 37.57061675234485, 127.1038326040087 37.57052976854222, 127.1037982447711 37.57048290019421, 127.1037489912142 37.57041569244844, 127.1034962675852 37.57002500988836, 127.1034290276621 37.56989392598739, 127.1033848564329 37.56978646732822, 127.103372979084 37.56974860225521, 127.1033418450287 37.56964930403812, 127.1010925206889 37.56090988701311, 127.1010809708452 37.5608208395093, 127.1010806052731 37.56075561646482, 127.1011460799232 37.56002336317411)))"
71,서울특별시,광진구,능동,11215780,11867,5482,6385,"MULTIPOLYGON (((127.0886731878298 37.55329248576748, 127.0896283118283 37.55239905986659, 127.0895481149758 37.55179027159712, 127.0859963653853 37.54944792498676, 127.0854763663104 37.54879937891257, 127.0854230179681 37.54872257750518, 127.0853793913233 37.54855229392436, 127.085687082429 37.54614000048253, 127.0850645157521 37.5451080188944, 127.0816136180864 37.54529864575228, 127.0808521419007 37.54533447809324, 127.0805003967054 37.54535103072671, 127.0800021572363 37.54537742690876, 127.0799211014065 37.54538195180461, 127.0794790149448 37.54542964621464, 127.0787904918886 37.54557478879624, 127.078321553062 37.54567451735506, 127.0773314204087 37.54589843384859, 127.077276571686 37.5459197798487, 127.0770234179925 37.54602140223154, 127.0740568206921 37.54734047383357, 127.0742542405319 37.54759712408184, 127.0751880331766 37.54889117679154, 127.0761240642855 37.5505350827356, 127.0761402132226 37.55056416335719, 127.0761597913704 37.55059943235337, 127.0791996834301 37.55663424437545, 127.0791535763305 37.55699532105757, 127.079144132767 37.55703636469454, 127.0786614157165 37.55739392180736, 127.0779306730366 37.55777828455584, 127.078262836324 37.55776340581784, 127.0798590783885 37.55779731630052, 127.0796302140462 37.55723033119941, 127.0800924470351 37.55693476613206, 127.0813815322039 37.55643516176124, 127.0831025057623 37.5557676247432, 127.0852124069335 37.55493666318063, 127.0874122248515 37.55406217219517, 127.0882901361815 37.55358639322325, 127.0886418495666 37.55332284681184, 127.0886731878298 37.55329248576748)))"
72,서울특별시,광진구,구의1동,11215850,23126,11047,12079,"MULTIPOLYGON (((127.0850645157521 37.5451080188944, 127.0853106693867 37.54509311893946, 127.0906541485839 37.54468584880315, 127.0890534401648 37.53789877207256, 127.0835494896984 37.53662995568042, 127.0831992577068 37.54007076703593, 127.0829344891279 37.54137228907479, 127.0824739408193 37.54149572445384, 127.0814049050894 37.54201583733277, 127.0813110767247 37.54212009329554, 127.0812795590498 37.54215511631794, 127.0812766988486 37.5426665343926, 127.0812758854878 37.54281196495609, 127.0812995271387 37.54290202192861, 127.0813472430542 37.54308375081293, 127.0813719125099 37.54311959047246, 127.0815149775802 37.54332545752192, 127.081770501862 37.54381196715663, 127.0819175076054 37.54409303407575, 127.0823767315261 37.54497122551575, 127.0816136180864 37.54529864575228, 127.0850645157521 37.5451080188944)))"
73,서울특별시,광진구,구의2동,11215860,28032,13518,14514,"MULTIPOLYGON (((127.104246389703 37.55987605946643, 127.1033949187177 37.55723562067737, 127.1020296533363 37.55549522028099, 127.1000754081297 37.55300384016446, 127.0995721467145 37.55263487827198, 127.0986918609648 37.55198851293662, 127.0982411118768 37.55029188463994, 127.0982513445528 37.55021476091625, 127.098647637906 37.54901839481435, 127.0980151915236 37.54623106070981, 127.0977806520479 37.54550692553789, 127.097584114946 37.54560272782236, 127.0974592984283 37.5456635674121, 127.0969648739709 37.54590299303626, 127.0967465454933 37.54584703970973, 127.0939534607165 37.5442431984203, 127.0931787874994 37.5436941762887, 127.0924749217409 37.54411816990355, 127.0906541485839 37.54468584880315, 127.0853106693867 37.54509311893946, 127.0850645157521 37.5451080188944, 127.085687082429 37.54614000048253, 127.0853793913233 37.54855229392436, 127.0854230179681 37.54872257750518, 127.0854763663104 37.54879937891257, 127.0859963653853 37.54944792498676, 127.0895481149758 37.55179027159712, 127.0896283118283 37.55239905986659, 127.0902850237825 37.55258783755244, 127.0909072583408 37.55279779740976, 127.0928145428546 37.55448878831494, 127.0961391577987 37.55718623678302, 127.0976713000841 37.55742694586986, 127.0994576815695 37.55822564611957, 127.1003390803559 37.55901449924623, 127.100897198902 37.55958423889474, 127.1011460799232 37.56002336317411, 127.104246389703 37.55987605946643)))"
74,서울특별시,광진구,구의3동,11215870,30179,14399,15780,"MULTIPOLYGON (((127.0931787874994 37.5436941762887, 127.0950792358271 37.54186523565674, 127.0969692417208 37.54022785602624, 127.0970544587053 37.54016508806427, 127.097126219368 37.54011234226454, 127.0977484126165 37.53965589908915, 127.1006138691992 37.53709112964368, 127.1032018006623 37.53466506706074, 127.0989571712764 37.52795365256429, 127.0981175409782 37.52755870823859, 127.0922507470111 37.5267860261998, 127.0918179481839 37.53144335593444, 127.091674456374 37.53297967150279, 127.0916474362909 37.5332646317976, 127.0908756430952 37.53365630269627, 127.0901303530015 37.53340420332466, 127.0894390426556 37.53569626694799, 127.0893682018379 37.53596809469673, 127.0892612745928 37.53637842529371, 127.089418106094 37.53745045643191, 127.0890534401648 37.53789877207256, 127.0906541485839 37.54468584880315, 127.0924749217409 37.54411816990355, 127.0931787874994 37.5436941762887)))"
75,서울특별시,광진구,광장동,11215810,36180,17487,18693,"MULTIPOLYGON (((127.1137691771839 37.55888549092251, 127.1138968924526 37.55859879907216, 127.1138942621246 37.5566619551125, 127.1138921667855 37.55512365449116, 127.1138893953175 37.55333036745829, 127.1133570809716 37.55203104636526, 127.1133429826299 37.55199663159392, 127.1130704327739 37.5513311889072, 127.1124444759977 37.54950727503481, 127.1122233080118 37.54834157252363, 127.1120718602993 37.54754560584924, 127.1115685106824 37.54650964728895, 127.1108865233861 37.5454748474335, 127.1095643777354 37.54346998109902, 127.1041582268374 37.53600340990382, 127.1032018006623 37.53466506706074, 127.1006138691992 37.53709112964368, 127.0977484126165 37.53965589908915, 127.097126219368 37.54011234226454, 127.0970544587053 37.54016508806427, 127.0969692417208 37.54022785602624, 127.0950792358271 37.54186523565674, 127.0931787874994 37.5436941762887, 127.0939534607165 37.5442431984203, 127.0967465454933 37.54584703970973, 127.0969648739709 37.54590299303626, 127.0974592984283 37.5456635674121, 127.097584114946 37.54560272782236, 127.0977806520479 37.54550692553789, 127.0980151915236 37.54623106070981, 127.098647637906 37.54901839481435, 127.0982513445528 37.55021476091625, 127.0982411118768 37.55029188463994, 127.0986918609648 37.55198851293662, 127.0995721467145 37.55263487827198, 127.1000754081297 37.55300384016446, 127.1020296533363 37.55549522028099, 127.1033949187177 37.55723562067737, 127.104246389703 37.55987605946643, 127.1089603869398 37.55982369013402, 127.1100221982408 37.55845873405385, 127.1114650085899 37.55888875248189, 127.1137691771839 37.55888549092251)))"
76,서울특별시,광진구,자양1동,11215820,24229,11662,12567,"MULTIPOLYGON (((127.0835494896984 37.53662995568042, 127.083791443284 37.53598418567623, 127.0842135549684 37.53488366510672, 127.0845802498034 37.53394641947021, 127.0848191856549 37.53335914699399, 127.0848334855933 37.53332419403093, 127.085146311817 37.53277549538184, 127.0853482098607 37.53246413533648, 127.0843189030068 37.53196251783828, 127.0839867042226 37.53180817350854, 127.0833003090271 37.53157359951717, 127.0829306614222 37.53151595992028, 127.0825942037055 37.53146970342518, 127.0821111691998 37.53145109385735, 127.0815974102458 37.53148645570238, 127.0815336895433 37.5314944593063, 127.0813793824933 37.53151385041484, 127.0811665709066 37.53156779913177, 127.0810506895012 37.53159718691175, 127.078407596679 37.53238203276661, 127.0756604886662 37.53320488831465, 127.0765499671096 37.5360338288817, 127.076575682035 37.53611616970771, 127.0766121311285 37.53623787511913, 127.0770908039641 37.53784974316093, 127.077170829003 37.53820596198495, 127.0771311820065 37.53821606301026, 127.0751353877829 37.53871142962469, 127.0752642196528 37.5393269348552, 127.0767803184492 37.53921193022391, 127.0784788462719 37.53902187973175, 127.0789410400282 37.53893460102604, 127.0799481177514 37.53900248300937, 127.0822903619827 37.54003782342225, 127.0829344891279 37.54137228907479, 127.0831992577068 37.54007076703593, 127.0835494896984 37.53662995568042)))"
77,서울특별시,광진구,자양2동,11215830,27107,13290,13817,"MULTIPOLYGON (((127.0922507470111 37.5267860261998, 127.0904378750911 37.5260022728048, 127.0885196237984 37.52549085969232, 127.0875943179362 37.52524537819027, 127.0855904208734 37.52474261757749, 127.0842850790763 37.52442030365822, 127.083421341676 37.52431134900936, 127.0823646383488 37.5241780488388, 127.0798900799743 37.52386618950383, 127.0775801807529 37.52357514972427, 127.0769469501969 37.52359316911708, 127.0728546030312 37.52371250986057, 127.0725769188417 37.52377686080059, 127.0738591890845 37.52703312999861, 127.0748646618163 37.53055994174971, 127.0756604886662 37.53320488831465, 127.078407596679 37.53238203276661, 127.0810506895012 37.53159718691175, 127.0811665709066 37.53156779913177, 127.0813793824933 37.53151385041484, 127.0815336895433 37.5314944593063, 127.0815974102458 37.53148645570238, 127.0821111691998 37.53145109385735, 127.0825942037055 37.53146970342518, 127.0829306614222 37.53151595992028, 127.0833003090271 37.53157359951717, 127.0839867042226 37.53180817350854, 127.0843189030068 37.53196251783828, 127.0853482098607 37.53246413533648, 127.085146311817 37.53277549538184, 127.0848334855933 37.53332419403093, 127.0848191856549 37.53335914699399, 127.0845802498034 37.53394641947021, 127.0842135549684 37.53488366510672, 127.083791443284 37.53598418567623, 127.0835494896984 37.53662995568042, 127.0890534401648 37.53789877207256, 127.089418106094 37.53745045643191, 127.0892612745928 37.53637842529371, 127.0893682018379 37.53596809469673, 127.0894390426556 37.53569626694799, 127.0901303530015 37.53340420332466, 127.0908756430952 37.53365630269627, 127.0916474362909 37.5332646317976, 127.091674456374 37.53297967150279, 127.0918179481839 37.53144335593444, 127.0922507470111 37.5267860261998)))"
78,서울특별시,광진구,자양3동,11215840,29577,14247,15330,"MULTIPOLYGON (((127.0751353877829 37.53871142962469, 127.0771311820065 37.53821606301026, 127.077170829003 37.53820596198495, 127.0770908039641 37.53784974316093, 127.0766121311285 37.53623787511913, 127.076575682035 37.53611616970771, 127.0765499671096 37.5360338288817, 127.0756604886662 37.53320488831465, 127.0748646618163 37.53055994174971, 127.0738591890845 37.52703312999861, 127.0725769188417 37.52377686080059, 127.0669618590224 37.52508139275426, 127.0652649061698 37.52560351988906, 127.0655591526123 37.52741300643453, 127.0671510058731 37.53251141564537, 127.0676565356706 37.53360240527236, 127.0679740699094 37.53427441868639, 127.0705546653783 37.53983166852371, 127.0732732417561 37.53907450660557, 127.0751353877829 37.53871142962469)))"
79,서울특별시,광진구,자양4동,11215847,23368,11530,11838,"MULTIPOLYGON (((127.0705546653783 37.53983166852371, 127.0679740699094 37.53427441868639, 127.0676565356706 37.53360240527236, 127.0671510058731 37.53251141564537, 127.0655591526123 37.52741300643453, 127.0652649061698 37.52560351988906, 127.0602520021255 37.52752180766007, 127.0565665637636 37.52910117290874, 127.0628263118332 37.54018625021281, 127.0639433937799 37.54215094444825, 127.0705546653783 37.53983166852371)))"
80,서울특별시,동대문구,회기동,11230710,13337,5951,7386,"MULTIPOLYGON (((127.0520299418043 37.59995268207152, 127.0526334147451 37.59942320859219, 127.0536466669667 37.597535331009, 127.054601844735 37.59573284360998, 127.0550486760181 37.59357475002138, 127.0569026659942 37.59144767105084, 127.0532757109514 37.58780838437516, 127.0528258085817 37.58727826658781, 127.0518315912493 37.58792008411469, 127.0482554867205 37.58880779770388, 127.0477023440089 37.59013629102086, 127.0474134625989 37.59458557596919, 127.0475315904782 37.59565525011852, 127.0476473912901 37.5962876358017, 127.0477669425513 37.59666002479961, 127.0481580021938 37.5975561070469, 127.050273405968 37.60110534307088, 127.0510088535296 37.60156938532575, 127.0513273845387 37.60162650166031, 127.0520299418043 37.59995268207152)))"
81,서울특별시,동대문구,휘경1동,11230720,16537,8008,8529,"MULTIPOLYGON (((127.0696260938658 37.59488273131149, 127.0703550023807 37.59247539290008, 127.066108057859 37.5912340473427, 127.0657596342484 37.59113249125475, 127.0629488858646 37.59031654080835, 127.0626486424338 37.59023106269257, 127.0625559264639 37.59020466840749, 127.0609529939905 37.58974917140445, 127.0569925479329 37.5885975496964, 127.0566512884581 37.58848585348236, 127.0565712856308 37.58845942473467, 127.0564753546661 37.58842773351252, 127.0549491508005 37.58782028165879, 127.0532757109514 37.58780838437516, 127.0569026659942 37.59144767105084, 127.0571636292997 37.59186444390681, 127.0572535047459 37.59198984278272, 127.0576025580844 37.59246210468986, 127.0578006188273 37.59272987051349, 127.0578179024269 37.59275318998034, 127.0578441649956 37.59278862111161, 127.0589406180139 37.59282651943209, 127.0605563611527 37.59303310005994, 127.061626527757 37.59320044850501, 127.0644337632018 37.59463496838388, 127.0651239978236 37.59532137878429, 127.0696260938658 37.59488273131149)))"
82,서울특별시,동대문구,휘경2동,11230730,25176,12401,12775,"MULTIPOLYGON (((127.0707200795494 37.59091177981982, 127.0716255491389 37.58794738624849, 127.0736755995005 37.58535442252423, 127.0772292087177 37.58098209184888, 127.0760937804588 37.58098370915436, 127.0755055416514 37.58098497530478, 127.075346200421 37.58099904909201, 127.0750458044174 37.58104528881048, 127.0741508964517 37.58120092629859, 127.0734614469111 37.58132575240655, 127.0730100570601 37.58140974851106, 127.0691075943228 37.58216755032503, 127.0686849339017 37.58227961434974, 127.0683845472214 37.58225260894428, 127.0672607955547 37.58215157813991, 127.0643146198041 37.58301166663094, 127.0644554959438 37.58349214128163, 127.0644179272306 37.58461767248042, 127.0642601613277 37.58474065675114, 127.0640750452448 37.58488445826373, 127.0634926425736 37.58516138550262, 127.0630524935739 37.58530994482276, 127.062998590571 37.58532777040887, 127.0620503929213 37.58550452553118, 127.0616602593817 37.58551772427831, 127.0614270884545 37.58544363815172, 127.061286299474 37.58530902520792, 127.060666601691 37.58511856419937, 127.0599277146134 37.58509215322776, 127.0597189021789 37.58508911937475, 127.0578818431314 37.58510366165619, 127.0578110685299 37.58515289670323, 127.0578111117189 37.58533324011273, 127.0577312167122 37.5859131736633, 127.0575761813831 37.58603540834689, 127.0575099528468 37.58608700734857, 127.0566583485542 37.58627252765504, 127.0563717421895 37.58632382536524, 127.0563010871966 37.58630102613324, 127.0560275448655 37.58599353976668, 127.0560667970535 37.58558244803633, 127.0559781960282 37.5852441098032, 127.0556044519265 37.58476386289378, 127.0549158331329 37.58426102182732, 127.054949172631 37.58769753010431, 127.0549491508005 37.58782028165879, 127.0564753546661 37.58842773351252, 127.0565712856308 37.58845942473467, 127.0566512884581 37.58848585348236, 127.0569925479329 37.5885975496964, 127.0609529939905 37.58974917140445, 127.0625559264639 37.59020466840749, 127.0626486424338 37.59023106269257, 127.0629488858646 37.59031654080835, 127.0657596342484 37.59113249125475, 127.066108057859 37.5912340473427, 127.0703550023807 37.59247539290008, 127.0707200795494 37.59091177981982)))"
83,서울특별시,동대문구,청량리동,11230705,22035,11029,11006,"MULTIPOLYGON (((127.0476473912901 37.5962876358017, 127.0475315904782 37.59565525011852, 127.0474134625989 37.59458557596919, 127.0477023440089 37.59013629102086, 127.0482554867205 37.58880779770388, 127.0518315912493 37.58792008411469, 127.0528258085817 37.58727826658781, 127.0507034964134 37.58468672322913, 127.0500579347569 37.58397557957707, 127.0498155838691 37.58378312027541, 127.0491308029042 37.58323969773345, 127.0489610056666 37.58310610130892, 127.046372545114 37.58108505130353, 127.0461986168433 37.58094924563569, 127.0442620551672 37.58003596989686, 127.0434707995235 37.57976794881171, 127.0433484653968 37.58133816189984, 127.0441064758848 37.58136024909316, 127.0437100772393 37.58263073945345, 127.0424001827911 37.58673079179184, 127.042138498548 37.58672838893818, 127.04185608728 37.58671851852655, 127.0415422664345 37.58670700667953, 127.041371805496 37.58669914272489, 127.0405954376916 37.58666570318051, 127.0404163833042 37.58665824605945, 127.0396509119258 37.58855815995449, 127.0398043091487 37.58879993747242, 127.040326302741 37.58956473514086, 127.0405924978775 37.58990828369627, 127.040670460742 37.59000886179584, 127.0405842636038 37.59055722031734, 127.0399792153793 37.59125348743314, 127.0390627541217 37.59127014721531, 127.0407538027052 37.59580029601416, 127.0435174311994 37.59690618222339, 127.0476473912901 37.5962876358017)))"
84,서울특별시,동대문구,용신동,11230536,32073,16401,15672,"MULTIPOLYGON (((127.0425056318665 37.57934632328571, 127.0449158737198 37.57735460914232, 127.0421804638618 37.57302096202505, 127.0386504761305 37.57295539101556, 127.0379847878536 37.57290321345877, 127.0379274804577 37.57289848242191, 127.036533410708 37.57251670570779, 127.0364781687079 37.57249708189399, 127.0363730939317 37.57245974195402, 127.0354515110276 37.57212938037326, 127.0351015240643 37.57195787228406, 127.0347616574307 37.57175260339242, 127.0323108119812 37.57014415410847, 127.0303570854259 37.56981928565613, 127.0233681239995 37.5717398548992, 127.0231678778042 37.57804158355124, 127.0244723246175 37.57919734416113, 127.0294990434234 37.58272479417522, 127.0298206331878 37.58122645709881, 127.0305655464769 37.58129928611333, 127.0316311956234 37.58134971863695, 127.0327640671685 37.57893296037335, 127.0328172851168 37.57868641017713, 127.0328305577632 37.57860964902248, 127.0328075561909 37.57854330088141, 127.0328179735113 37.57812308820244, 127.0335172802515 37.57806145880743, 127.0345022177302 37.57806158467368, 127.0351975080483 37.57806167265458, 127.0356016554308 37.57806586727921, 127.035871550208 37.57806867015619, 127.0361919668303 37.57807199902072, 127.0387297589234 37.5782319640046, 127.0388746570091 37.57826633063271, 127.0399475590811 37.57852289408291, 127.0425056318665 37.57934632328571)))"
85,서울특별시,동대문구,제기동,11230545,27630,13785,13845,"MULTIPOLYGON (((127.0434707995235 37.57976794881171, 127.0425056318665 37.57934632328571, 127.0399475590811 37.57852289408291, 127.0388746570091 37.57826633063271, 127.0387297589234 37.5782319640046, 127.0361919668303 37.57807199902072, 127.035871550208 37.57806867015619, 127.0356016554308 37.57806586727921, 127.0351975080483 37.57806167265458, 127.0345022177302 37.57806158467368, 127.0335172802515 37.57806145880743, 127.0328179735113 37.57812308820244, 127.0328075561909 37.57854330088141, 127.0328305577632 37.57860964902248, 127.0328172851168 37.57868641017713, 127.0327640671685 37.57893296037335, 127.0316311956234 37.58134971863695, 127.0305655464769 37.58129928611333, 127.0298206331878 37.58122645709881, 127.0294990434234 37.58272479417522, 127.03167802458 37.58507133104746, 127.0363886758233 37.58992339469189, 127.0364883094785 37.59124586018718, 127.0390627541217 37.59127014721531, 127.0399792153793 37.59125348743314, 127.0405842636038 37.59055722031734, 127.040670460742 37.59000886179584, 127.0405924978775 37.58990828369627, 127.040326302741 37.58956473514086, 127.0398043091487 37.58879993747242, 127.0396509119258 37.58855815995449, 127.0404163833042 37.58665824605945, 127.0405954376916 37.58666570318051, 127.041371805496 37.58669914272489, 127.0415422664345 37.58670700667953, 127.04185608728 37.58671851852655, 127.042138498548 37.58672838893818, 127.0424001827911 37.58673079179184, 127.0437100772393 37.58263073945345, 127.0441064758848 37.58136024909316, 127.0433484653968 37.58133816189984, 127.0434707995235 37.57976794881171)))"
86,서울특별시,동대문구,전농1동,11230560,31096,15635,15461,"MULTIPOLYGON (((127.0549158331329 37.58426102182732, 127.053738714762 37.58365267422649, 127.0535785198223 37.58345151881876, 127.0552282177763 37.58113897789983, 127.056073808036 37.57998627313602, 127.0569354808567 37.57881164663002, 127.05716707749 37.57849523317572, 127.0572049175209 37.57844129426018, 127.0572527489434 37.57837161922157, 127.0575227668793 37.57797809822451, 127.0576525897345 37.57778724125544, 127.0576995047689 37.57764450925141, 127.0577232276295 37.57757230913631, 127.0577484662422 37.57749466334221, 127.0577571160086 37.5774675327283, 127.0577205054097 37.57671714510182, 127.0576838450051 37.5759745231994, 127.0576323797705 37.57535567473446, 127.0542277739562 37.5735752046191, 127.052231615643 37.57336791213906, 127.0513302166193 37.57388404573549, 127.0506891549212 37.57425227975125, 127.0483497890845 37.57413648344375, 127.0472246338965 37.57281395166385, 127.0455228722741 37.57402310568241, 127.0449158737198 37.57735460914232, 127.0425056318665 37.57934632328571, 127.0434707995235 37.57976794881171, 127.0442620551672 37.58003596989686, 127.0461986168433 37.58094924563569, 127.046372545114 37.58108505130353, 127.0489610056666 37.58310610130892, 127.0491308029042 37.58323969773345, 127.0498155838691 37.58378312027541, 127.0500579347569 37.58397557957707, 127.0507034964134 37.58468672322913, 127.0528258085817 37.58727826658781, 127.0532757109514 37.58780838437516, 127.0549491508005 37.58782028165879, 127.054949172631 37.58769753010431, 127.0549158331329 37.58426102182732)))"
87,서울특별시,동대문구,전농2동,11230570,20341,9666,10675,"MULTIPOLYGON (((127.0683845472214 37.58225260894428, 127.0676739836371 37.57875951799138, 127.067010417307 37.57659947571062, 127.0643868683493 37.57644223500328, 127.0615116451852 37.57585472714364, 127.0600486911803 37.57548085967458, 127.0576323797705 37.57535567473446, 127.0576838450051 37.5759745231994, 127.0577205054097 37.57671714510182, 127.0577571160086 37.5774675327283, 127.0577484662422 37.57749466334221, 127.0577232276295 37.57757230913631, 127.0576995047689 37.57764450925141, 127.0576525897345 37.57778724125544, 127.0575227668793 37.57797809822451, 127.0572527489434 37.57837161922157, 127.0572049175209 37.57844129426018, 127.05716707749 37.57849523317572, 127.0569354808567 37.57881164663002, 127.056073808036 37.57998627313602, 127.0552282177763 37.58113897789983, 127.0535785198223 37.58345151881876, 127.053738714762 37.58365267422649, 127.0549158331329 37.58426102182732, 127.0556044519265 37.58476386289378, 127.0559781960282 37.5852441098032, 127.0560667970535 37.58558244803633, 127.0560275448655 37.58599353976668, 127.0563010871966 37.58630102613324, 127.0563717421895 37.58632382536524, 127.0566583485542 37.58627252765504, 127.0575099528468 37.58608700734857, 127.0575761813831 37.58603540834689, 127.0577312167122 37.5859131736633, 127.0578111117189 37.58533324011273, 127.0578110685299 37.58515289670323, 127.0578818431314 37.58510366165619, 127.0597189021789 37.58508911937475, 127.0599277146134 37.58509215322776, 127.060666601691 37.58511856419937, 127.061286299474 37.58530902520792, 127.0614270884545 37.58544363815172, 127.0616602593817 37.58551772427831, 127.0620503929213 37.58550452553118, 127.062998590571 37.58532777040887, 127.0630524935739 37.58530994482276, 127.0634926425736 37.58516138550262, 127.0640750452448 37.58488445826373, 127.0642601613277 37.58474065675114, 127.0644179272306 37.58461767248042, 127.0644554959438 37.58349214128163, 127.0643146198041 37.58301166663094, 127.0672607955547 37.58215157813991, 127.0683845472214 37.58225260894428)))"
88,서울특별시,동대문구,답십리2동,11230610,30439,14895,15544,"MULTIPOLYGON (((127.0663143464382 37.57276056292678, 127.0651793764433 37.57088270878604, 127.0648465680409 37.57042404962194, 127.0644076702357 37.56983204638322, 127.0640214265223 37.56931459905559, 127.062649886709 37.56748767170556, 127.0622404040799 37.56695435779708, 127.0611416974579 37.56556220016016, 127.0608798099275 37.56532913870527, 127.0577746000723 37.56301909685816, 127.0568373842199 37.56376600874093, 127.056993417974 37.56801974134164, 127.0575314863026 37.57421068886417, 127.0575911667174 37.57489030382627, 127.0576323797705 37.57535567473446, 127.0600486911803 37.57548085967458, 127.0615116451852 37.57585472714364, 127.0643868683493 37.57644223500328, 127.067010417307 37.57659947571062, 127.0670180906905 37.5765138829786, 127.0663143464382 37.57276056292678)))"
89,서울특별시,동대문구,장안1동,11230650,39351,19628,19723,"MULTIPOLYGON (((127.0785759598423 37.57186080820366, 127.078200348487 37.57094459708917, 127.0777770417743 37.57007891500324, 127.0768591693201 37.56843855225527, 127.0758481256997 37.56663673099033, 127.0721016615051 37.56004560739462, 127.0707073251638 37.56058360964267, 127.0696908565203 37.56075341933541, 127.0689163529316 37.56086882865115, 127.0655457134635 37.56134570763972, 127.0655041845152 37.56114736134133, 127.0633071391025 37.56148372542138, 127.0593885097285 37.56223137955729, 127.0590533052705 37.56231181295948, 127.0587070964176 37.56245811550777, 127.058203099727 37.56271987461578, 127.0581434085977 37.56276133867567, 127.0577746000723 37.56301909685816, 127.0608798099275 37.56532913870527, 127.0611416974579 37.56556220016016, 127.0622404040799 37.56695435779708, 127.062649886709 37.56748767170556, 127.0640214265223 37.56931459905559, 127.0644076702357 37.56983204638322, 127.0648465680409 37.57042404962194, 127.0651793764433 37.57088270878604, 127.0663143464382 37.57276056292678, 127.0709445304105 37.57240454886127, 127.0714136876545 37.57180347674947, 127.0713624749408 37.57172442185963, 127.0710769702417 37.57128173278679, 127.0708650950607 37.57095308799014, 127.0701299721303 37.56980344644208, 127.0691023869675 37.56819529812216, 127.0687801622556 37.56769000573443, 127.0714577983213 37.56761971865076, 127.0719135606466 37.56769965169394, 127.0724409296441 37.56779394214856, 127.0738431000045 37.57049855411257, 127.0744472801224 37.57215809052133, 127.0753436755212 37.57209484302141, 127.0785759598423 37.57186080820366)))"
90,서울특별시,동대문구,장안2동,11230660,31930,15952,15978,"MULTIPOLYGON (((127.0772292087177 37.58098209184888, 127.0783181787224 37.57678350648899, 127.0786445102982 37.5726328332364, 127.0785759598423 37.57186080820366, 127.0753436755212 37.57209484302141, 127.0744472801224 37.57215809052133, 127.0738431000045 37.57049855411257, 127.0724409296441 37.56779394214856, 127.0719135606466 37.56769965169394, 127.0714577983213 37.56761971865076, 127.0687801622556 37.56769000573443, 127.0691023869675 37.56819529812216, 127.0701299721303 37.56980344644208, 127.0708650950607 37.57095308799014, 127.0710769702417 37.57128173278679, 127.0713624749408 37.57172442185963, 127.0714136876545 37.57180347674947, 127.0709445304105 37.57240454886127, 127.0663143464382 37.57276056292678, 127.0670180906905 37.5765138829786, 127.067010417307 37.57659947571062, 127.0676739836371 37.57875951799138, 127.0683845472214 37.58225260894428, 127.0686849339017 37.58227961434974, 127.0691075943228 37.58216755032503, 127.0730100570601 37.58140974851106, 127.0734614469111 37.58132575240655, 127.0741508964517 37.58120092629859, 127.0750458044174 37.58104528881048, 127.075346200421 37.58099904909201, 127.0755055416514 37.58098497530478, 127.0760937804588 37.58098370915436, 127.0772292087177 37.58098209184888)))"
91,서울특별시,동대문구,이문1동,11230740,22622,10746,11876,"MULTIPOLYGON (((127.0698296746509 37.59774863498778, 127.0696260938658 37.59488273131149, 127.0651239978236 37.59532137878429, 127.0644337632018 37.59463496838388, 127.061626527757 37.59320044850501, 127.0605563611527 37.59303310005994, 127.0589406180139 37.59282651943209, 127.0578441649956 37.59278862111161, 127.0578179024269 37.59275318998034, 127.0578006188273 37.59272987051349, 127.0576025580844 37.59246210468986, 127.0572535047459 37.59198984278272, 127.0571636292997 37.59186444390681, 127.0569026659942 37.59144767105084, 127.0550486760181 37.59357475002138, 127.054601844735 37.59573284360998, 127.0536466669667 37.597535331009, 127.0526334147451 37.59942320859219, 127.0520299418043 37.59995268207152, 127.057255966424 37.6012522988318, 127.0600456334621 37.60209985451751, 127.0607733621091 37.60356950262505, 127.0620385493922 37.60153829239305, 127.0619999798389 37.60064587237894, 127.0619838312215 37.6002570337205, 127.0684499825962 37.59784949642629, 127.0698296746509 37.59774863498778)))"
92,서울특별시,동대문구,이문2동,11230750,21273,10349,10924,"MULTIPOLYGON (((127.0717177603203 37.6068117515544, 127.0723165138998 37.60465633791907, 127.072438856435 37.60406384272963, 127.0727009419897 37.60279298149884, 127.072720652335 37.60244274081308, 127.0727095958849 37.60227031954161, 127.0726534975697 37.60167973571335, 127.0726287347916 37.60160414040481, 127.0726117426965 37.60155226777895, 127.0724642830977 37.60111157192675, 127.071985081265 37.60032416884648, 127.0718030609064 37.60007384508849, 127.0716162636858 37.59981695092646, 127.0698296746509 37.59774863498778, 127.0684499825962 37.59784949642629, 127.0619838312215 37.6002570337205, 127.0619999798389 37.60064587237894, 127.0620385493922 37.60153829239305, 127.0607733621091 37.60356950262505, 127.061668509318 37.60462965644957, 127.062139951897 37.60513615905444, 127.0623345955003 37.60528110417022, 127.064972936501 37.60587447100198, 127.0662463975172 37.60582057098255, 127.0681011504813 37.60650789692986, 127.068734389877 37.60687113867245, 127.0685882657387 37.60932246543619, 127.0688732382814 37.60932980814445, 127.0693552107858 37.60933156792092, 127.0717177603203 37.6068117515544)))"
93,서울특별시,동대문구,답십리1동,11230600,29939,14512,15427,"MULTIPOLYGON (((127.0576323797705 37.57535567473446, 127.0575911667174 37.57489030382627, 127.0575314863026 37.57421068886417, 127.056993417974 37.56801974134164, 127.0568373842199 37.56376600874093, 127.0486572587522 37.56986639461969, 127.0421804638618 37.57302096202505, 127.0449158737198 37.57735460914232, 127.0455228722741 37.57402310568241, 127.0472246338965 37.57281395166385, 127.0483497890845 37.57413648344375, 127.0506891549212 37.57425227975125, 127.0513302166193 37.57388404573549, 127.052231615643 37.57336791213906, 127.0542277739562 37.5735752046191, 127.0576323797705 37.57535567473446)))"
94,서울특별시,중랑구,면목2동,11260520,26156,13076,13080,"MULTIPOLYGON (((127.0867682501437 37.59276612887307, 127.084086078108 37.58761225972578, 127.0736755995005 37.58535442252423, 127.0716255491389 37.58794738624849, 127.0707200795494 37.59091177981982, 127.0786537526984 37.5929650060948, 127.0790271628211 37.59216302450955, 127.0801222003581 37.59156414965205, 127.0842952330002 37.59224162675861, 127.0867682501437 37.59276612887307)))"
95,서울특별시,중랑구,면목4동,11260540,20237,10046,10191,"MULTIPOLYGON (((127.095751117705 37.57110356167774, 127.0956502566457 37.57109563049658, 127.0955077303121 37.57105132491201, 127.0954432496255 37.57103056670222, 127.0953088319397 37.57097406455625, 127.0951467047176 37.57090493396179, 127.0950984055758 37.57088433471073, 127.0949572186979 37.5708169882403, 127.0947721133125 37.5707282018701, 127.0945719425608 37.57060310937155, 127.0944283363755 37.5705539972838, 127.0943190353236 37.57051661230069, 127.0942797039115 37.57050149219167, 127.0941883839337 37.57046546231959, 127.0940940190904 37.57044903077771, 127.0939783173292 37.57042887531118, 127.0939310048473 37.57042063648465, 127.0938041459436 37.57040521061167, 127.0936544502246 37.57038701096331, 127.0934530500668 37.57033110987896, 127.0933130156736 37.5703126005555, 127.0932297338196 37.57031974075185, 127.0930857153759 37.57033209768312, 127.0929231894347 37.57035558538936, 127.0927811420569 37.57037611497638, 127.0926920006641 37.57039662864189, 127.0926316243867 37.57041052644528, 127.0925334194428 37.57024681784164, 127.092486120977 37.57009680513882, 127.0924019599979 37.56995567864796, 127.0923121613131 37.56987102744539, 127.092226723634 37.56982855098566, 127.0920753356982 37.56975963353647, 127.0919503380712 37.56970843751996, 127.0918034663821 37.56964827842779, 127.0914584312257 37.56958511708553, 127.0912116349021 37.56956280161948, 127.0911704143874 37.56955933289674, 127.0907657501371 37.56957616514827, 127.0907209989502 37.56957805607605, 127.0904610890525 37.56960757528743, 127.0903513283238 37.56961958803458, 127.0902320795785 37.56964580006434, 127.0900990668529 37.56967504680114, 127.0899995242394 37.569699744245, 127.089902524972 37.5697644992237, 127.0898587688577 37.56980379930632, 127.0897688098207 37.56988459021333, 127.0895815164996 37.56996618742136, 127.0893103139441 37.57011960045174, 127.0891850045097 37.57015633612885, 127.0890858081777 37.57018131702684, 127.0889829636187 37.57018148990462, 127.0889222015686 37.57016782389041, 127.0887612248065 37.57013593682696, 127.0887108167531 37.57012652689168, 127.0883958317061 37.57007586386644, 127.0883258843631 37.57029643537405, 127.0882963490671 37.57038941207422, 127.0881601135496 37.57081847785512, 127.0880545551454 37.57082785044667, 127.0880098050867 37.57082938882181, 127.0878993722397 37.57083351012508, 127.0875900255644 37.57084482341646, 127.0875468475305 37.57084467257016, 127.0872305041583 37.57084131354029, 127.087183126323 37.57083946505647, 127.0871275432726 37.57083757343601, 127.0870368457857 37.5708380493905, 127.0870047406904 37.57083827057898, 127.0869572709058 37.57083810450286, 127.086884128424 37.57083810545645, 127.0868348759832 37.57083880289541, 127.0867166884517 37.57083838920319, 127.0861650572925 37.5708206831413, 127.0809830632769 37.57161023856756, 127.0785759598423 37.57186080820366, 127.0786445102982 37.5726328332364, 127.0783181787224 37.57678350648899, 127.0786599536358 37.57692668926768, 127.0796101006107 37.57738413200832, 127.0796601344414 37.57679392684803, 127.0806766673341 37.57637155119728, 127.0859120967074 37.57678009444723, 127.0887119350296 37.57700832444925, 127.0887643436656 37.57699499581478, 127.0921444082426 37.57461589375523, 127.0925793434812 37.57429178316848, 127.0949023676248 37.57245201094968, 127.0954528307744 37.57196266294532, 127.0956278195623 37.57153850134337, 127.095751117705 37.57110356167774)))"
96,서울특별시,중랑구,면목5동,11260550,9876,5034,4842,"MULTIPOLYGON (((127.0835296539448 37.58443533598752, 127.0833901230395 37.58114714130743, 127.0796101006107 37.57738413200832, 127.0786599536358 37.57692668926768, 127.0783181787224 37.57678350648899, 127.0772292087177 37.58098209184888, 127.0736755995005 37.58535442252423, 127.084086078108 37.58761225972578, 127.0835296539448 37.58443533598752)))"
97,서울특별시,중랑구,면목7동,11260570,21913,10879,11034,"MULTIPOLYGON (((127.102678231876 37.57891294732714, 127.1026716405845 37.57830360868783, 127.1012552952959 37.5749805200241, 127.1009302111809 37.57355979582311, 127.095751117705 37.57110356167774, 127.0956278195623 37.57153850134337, 127.0954528307744 37.57196266294532, 127.0949023676248 37.57245201094968, 127.0925793434812 37.57429178316848, 127.0921444082426 37.57461589375523, 127.0887643436656 37.57699499581478, 127.0887119350296 37.57700832444925, 127.0859120967074 37.57678009444723, 127.0806766673341 37.57637155119728, 127.0796601344414 37.57679392684803, 127.0796101006107 37.57738413200832, 127.0833901230395 37.58114714130743, 127.0858727874576 37.58098011441208, 127.0890563589663 37.58065324102953, 127.0916351765142 37.5806362704135, 127.0949841426099 37.58074357766383, 127.0997799067476 37.57954649869457, 127.102678231876 37.57891294732714)))"
98,서울특별시,중랑구,상봉1동,11260580,25629,12506,13123,"MULTIPOLYGON (((127.0958018936244 37.60061320958032, 127.0955192075844 37.59946301108777, 127.0927889339137 37.59816366073135, 127.0893569204551 37.5973435878665, 127.0864028007525 37.59661921665236, 127.0855382645975 37.59637507389674, 127.08491432055 37.59619964343527, 127.0825254405168 37.59553972417762, 127.0812909538832 37.59524241380746, 127.0805228986473 37.59505798427498, 127.0802814067214 37.59499999754824, 127.0803261159989 37.59587220591037, 127.0808246443618 37.59595507518425, 127.0830578774702 37.59642379938609, 127.0830967618642 37.59643294929978, 127.0862475764357 37.60022968908263, 127.0865298268194 37.60065994480899, 127.086988500663 37.60196511939214, 127.0870914996637 37.60421208184839, 127.0869561396174 37.60628132055198, 127.0867190823432 37.60689340476858, 127.086371138394 37.60756263354027, 127.0860978080153 37.6087322228127, 127.0864977629179 37.60938247803962, 127.087163945 37.60961845404541, 127.0879600781719 37.60990034657649, 127.0907496670718 37.60743607121592, 127.0912699197307 37.60726317564252, 127.0936336060981 37.60495248516163, 127.0942874177249 37.60242871531904, 127.0951043871889 37.60088458797502, 127.0954403399942 37.60056012900045, 127.0954680978435 37.60053431046378, 127.0957359841163 37.60059762851508, 127.0958018936244 37.60061320958032)))"
99,서울특별시,중랑구,상봉2동,11260590,19728,9639,10089,"MULTIPOLYGON (((127.0931989735586 37.59414612035095, 127.0878748427588 37.59300681409848, 127.0867682501437 37.59276612887307, 127.0842952330002 37.59224162675861, 127.0801222003581 37.59156414965205, 127.0790271628211 37.59216302450955, 127.0786537526984 37.5929650060948, 127.0707200795494 37.59091177981982, 127.0703550023807 37.59247539290008, 127.0802814067214 37.59499999754824, 127.0805228986473 37.59505798427498, 127.0812909538832 37.59524241380746, 127.0825254405168 37.59553972417762, 127.08491432055 37.59619964343527, 127.0855382645975 37.59637507389674, 127.0864028007525 37.59661921665236, 127.0893569204551 37.5973435878665, 127.0927889339137 37.59816366073135, 127.0931989735586 37.59414612035095)))"
100,서울특별시,중랑구,중화1동,11260600,21001,10334,10667,"MULTIPOLYGON (((127.0803261159989 37.59587220591037, 127.0803327710503 37.59707132035866, 127.0802846998789 37.59736684484184, 127.080228142044 37.59767876162071, 127.0801542588088 37.5980821222135, 127.0794420369784 37.6019265787619, 127.0793795580336 37.60225484490171, 127.079057909569 37.60388725815429, 127.0787353919603 37.6053723070725, 127.0791259753906 37.6054154058281, 127.0794202463899 37.60544799113276, 127.0804846482539 37.60556671179516, 127.0832502775487 37.6066096763211, 127.0834514167228 37.60672868786344, 127.0851543854746 37.60800558255887, 127.0854259343764 37.60832651303438, 127.0856501746225 37.60862249162326, 127.0856697858909 37.60865631580942, 127.085807977507 37.60889795457648, 127.0859463146018 37.60923531820874, 127.0859790158221 37.6093627207209, 127.0864977629179 37.60938247803962, 127.0860978080153 37.6087322228127, 127.086371138394 37.60756263354027, 127.0867190823432 37.60689340476858, 127.0869561396174 37.60628132055198, 127.0870914996637 37.60421208184839, 127.086988500663 37.60196511939214, 127.0865298268194 37.60065994480899, 127.0862475764357 37.60022968908263, 127.0830967618642 37.59643294929978, 127.0830578774702 37.59642379938609, 127.0808246443618 37.59595507518425, 127.0803261159989 37.59587220591037)))"
101,서울특별시,중랑구,중화2동,11260610,27994,14386,13608,"MULTIPOLYGON (((127.0803261159989 37.59587220591037, 127.0802814067214 37.59499999754824, 127.0703550023807 37.59247539290008, 127.0696260938658 37.59488273131149, 127.0698296746509 37.59774863498778, 127.0716162636858 37.59981695092646, 127.0718030609064 37.60007384508849, 127.071985081265 37.60032416884648, 127.0724642830977 37.60111157192675, 127.0726117426965 37.60155226777895, 127.0726287347916 37.60160414040481, 127.0726534975697 37.60167973571335, 127.0727095958849 37.60227031954161, 127.072720652335 37.60244274081308, 127.0727009419897 37.60279298149884, 127.072438856435 37.60406384272963, 127.0723165138998 37.60465633791907, 127.0787353919603 37.6053723070725, 127.079057909569 37.60388725815429, 127.0793795580336 37.60225484490171, 127.0794420369784 37.6019265787619, 127.0801542588088 37.5980821222135, 127.080228142044 37.59767876162071, 127.0802846998789 37.59736684484184, 127.0803327710503 37.59707132035866, 127.0803261159989 37.59587220591037)))"
102,서울특별시,중랑구,묵1동,11260620,36063,17551,18512,"MULTIPOLYGON (((127.0895430036712 37.6196436667868, 127.0904939769921 37.6174905807709, 127.0903351672139 37.61726025744631, 127.0901735256811 37.61702641513915, 127.0887618959233 37.61500869899259, 127.0886707350716 37.61497063031987, 127.0858762775583 37.61488634179212, 127.0847622036056 37.61167830489973, 127.0847699719222 37.61152623592734, 127.0851583074954 37.61035922963106, 127.0853119159352 37.60998571366291, 127.0854027345706 37.60982604243912, 127.0859790158221 37.6093627207209, 127.0859463146018 37.60923531820874, 127.085807977507 37.60889795457648, 127.0856697858909 37.60865631580942, 127.0856501746225 37.60862249162326, 127.0854259343764 37.60832651303438, 127.0851543854746 37.60800558255887, 127.0834514167228 37.60672868786344, 127.0832502775487 37.6066096763211, 127.0804846482539 37.60556671179516, 127.0794202463899 37.60544799113276, 127.0791259753906 37.6054154058281, 127.0787353919603 37.6053723070725, 127.0774645507786 37.61209405940001, 127.0771322950569 37.61311927375202, 127.0763558779304 37.61551273685825, 127.0758492361736 37.61707830737428, 127.0816372327308 37.61925094176976, 127.0824457661857 37.61929549265066, 127.0841503734334 37.61963268875622, 127.0857277524712 37.62016784234584, 127.0879730824871 37.61988710210396, 127.0895430036712 37.6196436667868)))"
103,서울특별시,중랑구,묵2동,11260630,20094,9872,10222,"MULTIPOLYGON (((127.0787353919603 37.6053723070725, 127.0723165138998 37.60465633791907, 127.0717177603203 37.6068117515544, 127.0714587400475 37.61428027888826, 127.0714031371484 37.6156279752979, 127.0758492361736 37.61707830737428, 127.0763558779304 37.61551273685825, 127.0771322950569 37.61311927375202, 127.0774645507786 37.61209405940001, 127.0787353919603 37.6053723070725)))"
104,서울특별시,중랑구,망우3동,11260660,18025,9022,9003,"MULTIPOLYGON (((127.1123997606826 37.59186378093394, 127.1101433387404 37.58741619339007, 127.1097844232598 37.58769550595346, 127.1083303673206 37.58823487873856, 127.1081751682299 37.58826703840452, 127.1072567187105 37.58804878831802, 127.1061349449772 37.58799660303415, 127.1049245760165 37.58809621390876, 127.1021129206026 37.58898924283753, 127.0973909802758 37.59056939878639, 127.0936256877487 37.58974573729006, 127.0931989735586 37.59414612035095, 127.100088616344 37.59564003810571, 127.1008703778162 37.59471310772732, 127.1030596505583 37.59494470072692, 127.1037698773346 37.5949211734418, 127.1064349620677 37.59474531420094, 127.108082813916 37.59454790971372, 127.1123997606826 37.59186378093394)))"
105,서울특별시,중랑구,신내1동,11260680,40738,19911,20827,"MULTIPOLYGON (((127.1156745870115 37.61929460112488, 127.1169681520136 37.61743077296312, 127.116670562518 37.61576845816515, 127.1169258429377 37.61435817922736, 127.1173082196149 37.61292547965921, 127.1175866870543 37.61170699061383, 127.1167964526747 37.60990507764774, 127.1166150907928 37.60882189786027, 127.1152464223071 37.60906520523158, 127.1131170946472 37.60947736911027, 127.1126116637709 37.60985314910491, 127.1123776384147 37.61006555765152, 127.1122381423037 37.61019217994002, 127.1093979408199 37.61206549538871, 127.1050751511659 37.61305160080705, 127.1042938367891 37.61317905641817, 127.1036809924606 37.61327902293888, 127.1013445904993 37.61320354885488, 127.1011322567299 37.6099771502476, 127.1010984710855 37.60929990658209, 127.1020846436381 37.6090553607773, 127.1022880745086 37.60915068768924, 127.102450263318 37.60926610780185, 127.1026442061447 37.60942792405257, 127.1026822762979 37.60945959928296, 127.1028011708734 37.60953884009949, 127.1029779270024 37.60965663668443, 127.1031235946802 37.60969543378979, 127.1032756352129 37.60973537881977, 127.1035846695526 37.60954600831386, 127.1037997135208 37.60878721711224, 127.1037899154342 37.60849888467551, 127.1037498794334 37.60803263794972, 127.1035936289042 37.60732422327679, 127.103189631686 37.60593028879236, 127.1004652887326 37.60054680918478, 127.0981917025764 37.60004787348065, 127.0970906012023 37.59980638972757, 127.09668325672 37.59971711722005, 127.0955192075844 37.59946301108777, 127.0958018936244 37.60061320958032, 127.0966127343078 37.60097650661078, 127.0961463176266 37.60238438577576, 127.0956037975051 37.60394281501571, 127.0955264016954 37.60415115706571, 127.0955128343227 37.60420882368275, 127.0954988609463 37.60426823751522, 127.0954263585359 37.60458120634516, 127.0954096768633 37.60465325674711, 127.095364818976 37.6050913818769, 127.0951490038128 37.60746448597724, 127.0951418758137 37.60755466807351, 127.0951477292799 37.6077811509329, 127.0951831013408 37.60803668622339, 127.0951970939661 37.6080798905875, 127.0952835152726 37.60833538010137, 127.0954206763935 37.60863611071499, 127.0956492732025 37.60905151252652, 127.0957522241543 37.60923750336993, 127.0958806866902 37.60947030355801, 127.0958987889286 37.60950332770072, 127.0960023799173 37.60980372180356, 127.0960125515802 37.60983354604657, 127.0962154510004 37.61094402026381, 127.0962539121691 37.61116498111354, 127.0963981313487 37.61199583744422, 127.0964375790441 37.61242861734571, 127.0964252221536 37.61274855209381, 127.0964207602011 37.61278797061923, 127.0958768823963 37.61508543651667, 127.0904939769921 37.6174905807709, 127.0895430036712 37.6196436667868, 127.0924357476132 37.61827922804378, 127.0926075054631 37.61821109376334, 127.0930468069291 37.61804135536808, 127.0961481577492 37.61710221913889, 127.096815539729 37.61705380072442, 127.0969508346434 37.6170514687451, 127.0970417957927 37.61704990099349, 127.10049900621 37.61888140793475, 127.1014468806646 37.61975553566823, 127.101507534023 37.61980306100443, 127.1015509175861 37.61981460047555, 127.1018250808344 37.61988750714062, 127.1050234514556 37.62068355101992, 127.1057103671428 37.62083343234811, 127.105818891898 37.62077979728819, 127.1060421120816 37.6206407625183, 127.1061379416008 37.62059826863748, 127.1073502123296 37.62050092659408, 127.1087520297171 37.62046049677843, 127.1090838818008 37.62052018389861, 127.1095117518424 37.62063539511654, 127.1098293820873 37.62070629986278, 127.1100112276681 37.62074202632833, 127.110115213918 37.62076245187293, 127.1102413791635 37.62077365774147, 127.1103919982972 37.62078702632033, 127.1106448322583 37.62078898752345, 127.1108516968067 37.6207772764507, 127.1109792877535 37.620756290266, 127.1113402991612 37.620654952137, 127.1114779513915 37.6206058315855, 127.1127371283919 37.62007029167008, 127.1138293952263 37.6194868716051, 127.1139451642177 37.61942866310911, 127.1139947684253 37.61941868527366, 127.1156745870115 37.61929460112488)))"
106,서울특별시,중랑구,신내2동,11260690,22095,10588,11507,"MULTIPOLYGON (((127.0958018936244 37.60061320958032, 127.0957359841163 37.60059762851508, 127.0954680978435 37.60053431046378, 127.0954403399942 37.60056012900045, 127.0951043871889 37.60088458797502, 127.0942874177249 37.60242871531904, 127.0936336060981 37.60495248516163, 127.0912699197307 37.60726317564252, 127.0907496670718 37.60743607121592, 127.0879600781719 37.60990034657649, 127.087163945 37.60961845404541, 127.0864977629179 37.60938247803962, 127.0859790158221 37.6093627207209, 127.0854027345706 37.60982604243912, 127.0853119159352 37.60998571366291, 127.0851583074954 37.61035922963106, 127.0847699719222 37.61152623592734, 127.0847622036056 37.61167830489973, 127.0858762775583 37.61488634179212, 127.0886707350716 37.61497063031987, 127.0887618959233 37.61500869899259, 127.0901735256811 37.61702641513915, 127.0903351672139 37.61726025744631, 127.0904939769921 37.6174905807709, 127.0958768823963 37.61508543651667, 127.0964207602011 37.61278797061923, 127.0964252221536 37.61274855209381, 127.0964375790441 37.61242861734571, 127.0963981313487 37.61199583744422, 127.0962539121691 37.61116498111354, 127.0962154510004 37.61094402026381, 127.0960125515802 37.60983354604657, 127.0960023799173 37.60980372180356, 127.0958987889286 37.60950332770072, 127.0958806866902 37.60947030355801, 127.0957522241543 37.60923750336993, 127.0956492732025 37.60905151252652, 127.0954206763935 37.60863611071499, 127.0952835152726 37.60833538010137, 127.0951970939661 37.6080798905875, 127.0951831013408 37.60803668622339, 127.0951477292799 37.6077811509329, 127.0951418758137 37.60755466807351, 127.0951490038128 37.60746448597724, 127.095364818976 37.6050913818769, 127.0954096768633 37.60465325674711, 127.0954263585359 37.60458120634516, 127.0954988609463 37.60426823751522, 127.0955128343227 37.60420882368275, 127.0955264016954 37.60415115706571, 127.0956037975051 37.60394281501571, 127.0961463176266 37.60238438577576, 127.0966127343078 37.60097650661078, 127.0958018936244 37.60061320958032)))"
107,서울특별시,중랑구,면목본동,11260565,36247,18001,18246,"MULTIPOLYGON (((127.0936256877487 37.58974573729006, 127.0937725067138 37.58930334413929, 127.0946118848533 37.58673513659605, 127.094881107951 37.58590805503368, 127.0946078357725 37.5853932413482, 127.094555298755 37.58529506637232, 127.0942272287017 37.58469789575611, 127.0936982886081 37.58369219010851, 127.093098375802 37.58374534112259, 127.0924043043392 37.58380942092422, 127.0901181894183 37.58400800355088, 127.0856698612323 37.58438762505244, 127.0843292141613 37.58450008591404, 127.0840558561704 37.58452052998156, 127.0835296539448 37.58443533598752, 127.084086078108 37.58761225972578, 127.0867682501437 37.59276612887307, 127.0878748427588 37.59300681409848, 127.0931989735586 37.59414612035095, 127.0936256877487 37.58974573729006)))"
108,서울특별시,중랑구,면목3.8동,11260575,26729,13316,13413,"MULTIPOLYGON (((127.1101433387404 37.58741619339007, 127.1098392223031 37.58596590117586, 127.1095277165243 37.58506948085471, 127.1093280912254 37.58466434029016, 127.1060319735124 37.58456437613233, 127.1026655861381 37.58410467355501, 127.0997504858893 37.58305151357614, 127.1004722495404 37.58257399162129, 127.1027686396326 37.58176264040079, 127.1027645590944 37.58106408149668, 127.1027454193592 37.57960383207365, 127.1027259815373 37.57939983737086, 127.102678231876 37.57891294732714, 127.0997799067476 37.57954649869457, 127.0949841426099 37.58074357766383, 127.0916351765142 37.5806362704135, 127.0890563589663 37.58065324102953, 127.0858727874576 37.58098011441208, 127.0833901230395 37.58114714130743, 127.0835296539448 37.58443533598752, 127.0840558561704 37.58452052998156, 127.0843292141613 37.58450008591404, 127.0856698612323 37.58438762505244, 127.0901181894183 37.58400800355088, 127.0924043043392 37.58380942092422, 127.093098375802 37.58374534112259, 127.0936982886081 37.58369219010851, 127.0942272287017 37.58469789575611, 127.094555298755 37.58529506637232, 127.0946078357725 37.5853932413482, 127.094881107951 37.58590805503368, 127.0946118848533 37.58673513659605, 127.0937725067138 37.58930334413929, 127.0936256877487 37.58974573729006, 127.0973909802758 37.59056939878639, 127.1021129206026 37.58898924283753, 127.1049245760165 37.58809621390876, 127.1061349449772 37.58799660303415, 127.1072567187105 37.58804878831802, 127.1081751682299 37.58826703840452, 127.1083303673206 37.58823487873856, 127.1097844232598 37.58769550595346, 127.1101433387404 37.58741619339007)))"
109,서울특별시,중랑구,망우본동,11260655,31251,15798,15453,"MULTIPOLYGON (((127.1166150907928 37.60882189786027, 127.1171366196193 37.60860716005363, 127.1179009372873 37.60814093784693, 127.1181781793406 37.60779031061465, 127.1182071778494 37.60775350336734, 127.1183171676897 37.60761387125096, 127.11837502986 37.60737632861362, 127.1182758344828 37.6062797467466, 127.1180112146713 37.60457760024447, 127.1168905636074 37.60314984259239, 127.1152236096114 37.60125844369702, 127.1142823414738 37.60035168262228, 127.113831922295 37.59996368548224, 127.1138468516224 37.59981825256222, 127.113892244776 37.59952454781106, 127.1139627329203 37.59942081802319, 127.1159577748988 37.59727904864882, 127.1159997492211 37.59724087799227, 127.1164993609603 37.59678146815182, 127.1180180202399 37.59534453189995, 127.1183656471266 37.59501552460112, 127.1178238363405 37.5940053290751, 127.1153548684714 37.59350494793831, 127.1139057557191 37.59334278726774, 127.1123997606826 37.59186378093394, 127.108082813916 37.59454790971372, 127.1064349620677 37.59474531420094, 127.1037698773346 37.5949211734418, 127.1030596505583 37.59494470072692, 127.1008703778162 37.59471310772732, 127.100088616344 37.59564003810571, 127.0931989735586 37.59414612035095, 127.0927889339137 37.59816366073135, 127.0955192075844 37.59946301108777, 127.09668325672 37.59971711722005, 127.0970906012023 37.59980638972757, 127.0981917025764 37.60004787348065, 127.1004652887326 37.60054680918478, 127.103189631686 37.60593028879236, 127.1035936289042 37.60732422327679, 127.1037498794334 37.60803263794972, 127.1037899154342 37.60849888467551, 127.1037997135208 37.60878721711224, 127.1035846695526 37.60954600831386, 127.1032756352129 37.60973537881977, 127.1031235946802 37.60969543378979, 127.1029779270024 37.60965663668443, 127.1028011708734 37.60953884009949, 127.1026822762979 37.60945959928296, 127.1026442061447 37.60942792405257, 127.102450263318 37.60926610780185, 127.1022880745086 37.60915068768924, 127.1020846436381 37.6090553607773, 127.1010984710855 37.60929990658209, 127.1011322567299 37.6099771502476, 127.1013445904993 37.61320354885488, 127.1036809924606 37.61327902293888, 127.1042938367891 37.61317905641817, 127.1050751511659 37.61305160080705, 127.1093979408199 37.61206549538871, 127.1122381423037 37.61019217994002, 127.1123776384147 37.61006555765152, 127.1126116637709 37.60985314910491, 127.1131170946472 37.60947736911027, 127.1152464223071 37.60906520523158, 127.1166150907928 37.60882189786027)))"
110,서울특별시,성북구,돈암1동,11290580,16048,7496,8552,"MULTIPOLYGON (((127.0249932389109 37.59412913921373, 127.0247919443478 37.5941575342839, 127.0244872966719 37.59430390242731, 127.0225690510959 37.5956388232195, 127.0225307170053 37.59570097354779, 127.0220781719109 37.59660043622031, 127.0219710035833 37.59698199710697, 127.0214774279756 37.59710456087421, 127.0197225150752 37.59728835527325, 127.0187831448319 37.59847653768905, 127.0216393298334 37.60156623588291, 127.0259666281073 37.60317891367602, 127.0302197253746 37.60399827577248, 127.0292041988989 37.60302359437552, 127.0271198061784 37.60075345388685, 127.0267821524207 37.60020249738221, 127.0263034672244 37.59896101347057, 127.0260617944453 37.59765985500562, 127.0259126002736 37.59673537838021, 127.0259881011393 37.5963300768595, 127.0257019215789 37.5949025501829, 127.025335562186 37.59450271028933, 127.0249932389109 37.59412913921373)))"
111,서울특별시,성북구,돈암2동,11290590,25076,11975,13101,"MULTIPOLYGON (((127.0140815759509 37.60081316063695, 127.0139247155986 37.60067797936249, 127.0187831448319 37.59847653768905, 127.0197225150752 37.59728835527325, 127.0194879528297 37.59710486042732, 127.0182346441679 37.59690708900683, 127.0161518654741 37.59688166875825, 127.0150564626051 37.59841135863238, 127.0140169300119 37.59833035139047, 127.0133399138829 37.59825817630806, 127.0128871280058 37.59820560966027, 127.0126698080477 37.59668031379478, 127.0130660236616 37.59578915031513, 127.0134233472709 37.59523113291316, 127.0115447434885 37.5939659879073, 127.009531179565 37.59206377620858, 127.0074886570355 37.59163156262304, 127.007225070807 37.59185751731858, 127.0074698905532 37.59222411889534, 127.0074860115501 37.59224784644476, 127.0076573606005 37.59245925047057, 127.0076955003331 37.59247292971737, 127.007828274147 37.59252193068153, 127.00815068931 37.59269340334556, 127.0081830693211 37.59272170527142, 127.0084225698365 37.59312042099191, 127.0085017347026 37.5941077221173, 127.0084191381333 37.59460987722787, 127.0081027918431 37.59555947666733, 127.0078507444203 37.59598994410914, 127.0072463516857 37.59649217460777, 127.0069483315327 37.59659233112155, 127.0059204663541 37.59667591369166, 127.0056674236075 37.59726291294509, 127.005661892557 37.59734040979383, 127.0056556566835 37.59742855305786, 127.0057335576274 37.59763956826672, 127.0062563709295 37.59823664297899, 127.0063906024325 37.59838705272425, 127.0067239259987 37.59873096114864, 127.0112975872998 37.59972906747065, 127.0112277533637 37.60019742251565, 127.0113412762321 37.60084353348505, 127.0115549702278 37.60118805500853, 127.0124731637545 37.60186109848647, 127.0125489198381 37.60189054279768, 127.0126108785264 37.60191462117326, 127.0129844837448 37.60195221717829, 127.0130804667496 37.60194443804163, 127.0131431708272 37.60193935176453, 127.013241908454 37.60189131186875, 127.0134735535349 37.60165566457285, 127.0138599016194 37.601150251312, 127.0140815759509 37.60081316063695)))"
112,서울특별시,성북구,안암동,11290600,17877,8677,9200,"MULTIPOLYGON (((127.0364883094785 37.59124586018718, 127.0363886758233 37.58992339469189, 127.03167802458 37.58507133104746, 127.0294990434234 37.58272479417522, 127.0244723246175 37.57919734416113, 127.0223146245281 37.58222653237924, 127.0219182004647 37.58298953019839, 127.0219010244248 37.58302322054026, 127.0216226676274 37.58381869767417, 127.0212772663713 37.58480765177691, 127.0212521714733 37.58487954046699, 127.0211626021425 37.58513617779985, 127.0210261732401 37.58555045951535, 127.0209250893648 37.58585741709029, 127.020718996675 37.58631288562431, 127.0201404213551 37.58756002470839, 127.0198277139677 37.58786183029314, 127.0197500696196 37.58793587537134, 127.0197268596988 37.58795374474084, 127.0196876908485 37.58798389308596, 127.0192079908952 37.58834716057048, 127.0188769169233 37.58859774645194, 127.0187755264737 37.58867443597123, 127.0189641329387 37.58882833244873, 127.0196613301812 37.58940696166017, 127.0201785684579 37.58933695605252, 127.021325716187 37.58918049839718, 127.0216261444762 37.5891389024933, 127.0219010588421 37.58910170920575, 127.0221136192338 37.58907327628792, 127.0237298159903 37.59096249373135, 127.0237074925849 37.59124294718458, 127.0237881701208 37.59224827193234, 127.0238404269598 37.59239523065813, 127.0238820568131 37.59251229396126, 127.024464327476 37.59357372102119, 127.0249932389109 37.59412913921373, 127.0302610412393 37.59124987700547, 127.0318157187276 37.59111652675382, 127.0320300509465 37.59114554376117, 127.0332258070018 37.59148039532386, 127.0333190200456 37.5915182778909, 127.0335393421326 37.59160782312912, 127.0339530540326 37.59179197975218, 127.0342599657455 37.59193932174656, 127.0343567304835 37.59199637559475, 127.0347463249266 37.59221056624732, 127.0351374307179 37.5924225217227, 127.035334077508 37.5924856916529, 127.0355405147248 37.59255198688858, 127.0359268581543 37.59224366924932, 127.0363639257001 37.59160883545215, 127.0364975156522 37.5913434831689, 127.0364883094785 37.59124586018718)))"
113,서울특별시,성북구,보문동,11290610,16839,8140,8699,"MULTIPOLYGON (((127.0244723246175 37.57919734416113, 127.0231678778042 37.57804158355124, 127.0225087439379 37.57809642692493, 127.0187516636571 37.5775269002752, 127.0180055103903 37.57805818233138, 127.0176045239479 37.57968880236296, 127.0167863320873 37.58153662148743, 127.0163900710065 37.5818425829683, 127.0160673028117 37.58184013347665, 127.0149504964771 37.58213073135636, 127.0146858848304 37.58222654740629, 127.0146641329499 37.58448658194645, 127.0146857094254 37.58454413142786, 127.0165210981058 37.58686699309067, 127.0172924567512 37.58748961750423, 127.0187755264737 37.58867443597123, 127.0188769169233 37.58859774645194, 127.0192079908952 37.58834716057048, 127.0196876908485 37.58798389308596, 127.0197268596988 37.58795374474084, 127.0197500696196 37.58793587537134, 127.0198277139677 37.58786183029314, 127.0201404213551 37.58756002470839, 127.020718996675 37.58631288562431, 127.0209250893648 37.58585741709029, 127.0210261732401 37.58555045951535, 127.0211626021425 37.58513617779985, 127.0212521714733 37.58487954046699, 127.0212772663713 37.58480765177691, 127.0216226676274 37.58381869767417, 127.0219010244248 37.58302322054026, 127.0219182004647 37.58298953019839, 127.0223146245281 37.58222653237924, 127.0244723246175 37.57919734416113)))"
114,서울특별시,성북구,정릉1동,11290620,19484,9328,10156,"MULTIPOLYGON (((127.0216393298334 37.60156623588291, 127.0187831448319 37.59847653768905, 127.0139247155986 37.60067797936249, 127.0140815759509 37.60081316063695, 127.0134931245287 37.60268109372458, 127.0134800635189 37.60272265486918, 127.0134229018958 37.60293770488041, 127.0133117681945 37.60335628166465, 127.0147472483952 37.605375567037, 127.0157938455686 37.60734072556384, 127.0158426014877 37.60767736048323, 127.0154295478764 37.60945806848586, 127.0152636978044 37.60964347835233, 127.0149887297774 37.60995086968779, 127.0146912866348 37.61028314230451, 127.0143424801517 37.61067153751501, 127.0135736078478 37.61151675830042, 127.0134157672988 37.61161412844427, 127.014432729292 37.61357190921508, 127.0146011702583 37.61194574642968, 127.0157650055221 37.60996438420794, 127.0164042245264 37.60766163640255, 127.0177722060704 37.60383540293202, 127.0194873162128 37.6023789514552, 127.0216393298334 37.60156623588291)))"
115,서울특별시,성북구,정릉2동,11290630,23974,11678,12296,"MULTIPOLYGON (((127.0140815759509 37.60081316063695, 127.0138599016194 37.601150251312, 127.0134735535349 37.60165566457285, 127.013241908454 37.60189131186875, 127.0131431708272 37.60193935176453, 127.0130804667496 37.60194443804163, 127.0129844837448 37.60195221717829, 127.0126108785264 37.60191462117326, 127.0125489198381 37.60189054279768, 127.0124731637545 37.60186109848647, 127.0115549702278 37.60118805500853, 127.0113412762321 37.60084353348505, 127.0112277533637 37.60019742251565, 127.0112975872998 37.59972906747065, 127.0067239259987 37.59873096114864, 127.0063906024325 37.59838705272425, 127.0062563709295 37.59823664297899, 127.0057335576274 37.59763956826672, 127.0056556566835 37.59742855305786, 127.005661892557 37.59734040979383, 127.0056674236075 37.59726291294509, 127.0059204663541 37.59667591369166, 127.0047005277164 37.59676892968123, 127.0029390604743 37.59795682334006, 127.0029257295185 37.59889641712006, 127.0011484260152 37.60125494246453, 127.0009644800233 37.60147572377178, 127.0009435694918 37.60150081885615, 127.0006445677668 37.60165272823399, 126.999799239074 37.60167149279376, 126.9995592859183 37.60160772501445, 126.9993034613381 37.60217551127316, 126.9991322002841 37.60258489523706, 126.9991095556268 37.60275021342903, 126.999089019012 37.60290018169073, 126.9990680867347 37.60327640313354, 127.0002724854919 37.60370970514012, 127.0027238112228 37.60444670784715, 127.0046026276711 37.60482127540113, 127.0042161763158 37.60693956242607, 127.0036323481325 37.60773817556534, 127.0035257857307 37.60789771541886, 127.0035234184742 37.60804079341101, 127.0039643748836 37.60847527352081, 127.0041897389939 37.60868129375246, 127.0043920523356 37.60860665622966, 127.0066935724944 37.60729696154859, 127.0071300813745 37.60703401626617, 127.0074747078794 37.60679618667943, 127.0075782338162 37.606679833645, 127.0077105182351 37.6063119855116, 127.0077478205785 37.60623890708592, 127.0077679064252 37.60619955715894, 127.0079619266086 37.60598404419699, 127.009351321753 37.60615770372745, 127.0093751219156 37.60665354070099, 127.0093623381159 37.60698360398919, 127.009355585595 37.60714919746507, 127.0091895746664 37.60795070125594, 127.0089986912388 37.60866084038557, 127.0098288979962 37.60834964229412, 127.0105304921173 37.60809597840574, 127.0115814261201 37.60840969646697, 127.0116148330253 37.60957302861353, 127.0119759156326 37.61027713785473, 127.0134157672988 37.61161412844427, 127.0135736078478 37.61151675830042, 127.0143424801517 37.61067153751501, 127.0146912866348 37.61028314230451, 127.0149887297774 37.60995086968779, 127.0152636978044 37.60964347835233, 127.0154295478764 37.60945806848586, 127.0158426014877 37.60767736048323, 127.0157938455686 37.60734072556384, 127.0147472483952 37.605375567037, 127.0133117681945 37.60335628166465, 127.0134229018958 37.60293770488041, 127.0134800635189 37.60272265486918, 127.0134931245287 37.60268109372458, 127.0140815759509 37.60081316063695)))"
116,서울특별시,성북구,정릉3동,11290640,17388,8623,8765,"MULTIPOLYGON (((127.0089986912388 37.60866084038557, 127.0091895746664 37.60795070125594, 127.009355585595 37.60714919746507, 127.0093623381159 37.60698360398919, 127.0093751219156 37.60665354070099, 127.009351321753 37.60615770372745, 127.0079619266086 37.60598404419699, 127.0077679064252 37.60619955715894, 127.0077478205785 37.60623890708592, 127.0077105182351 37.6063119855116, 127.0075782338162 37.606679833645, 127.0074747078794 37.60679618667943, 127.0071300813745 37.60703401626617, 127.0066935724944 37.60729696154859, 127.0043920523356 37.60860665622966, 127.0041897389939 37.60868129375246, 127.0039643748836 37.60847527352081, 127.0035234184742 37.60804079341101, 127.0035257857307 37.60789771541886, 127.0036323481325 37.60773817556534, 127.0042161763158 37.60693956242607, 127.0046026276711 37.60482127540113, 127.0027238112228 37.60444670784715, 127.0002724854919 37.60370970514012, 126.9990680867347 37.60327640313354, 126.999089019012 37.60290018169073, 126.9991095556268 37.60275021342903, 126.9991322002841 37.60258489523706, 126.9993034613381 37.60217551127316, 126.9995592859183 37.60160772501445, 126.9972819143287 37.60207903668346, 126.9954192687897 37.60267386025694, 126.9952519743591 37.60270243849443, 126.9952040559209 37.6027003407264, 126.9951380053007 37.60269744430056, 126.9949378652085 37.60266278764521, 126.9944354636542 37.60257387336773, 126.9939254657319 37.60274858491162, 126.9894704711552 37.60252659458047, 126.9878876056661 37.601336703119, 126.9877411917167 37.60121553576545, 126.9865892817783 37.60512555693499, 126.9861944053272 37.60627838883232, 126.9859006036692 37.60713611432764, 126.9859576470348 37.60810754856134, 126.9859737283335 37.60837689415818, 126.9859989142313 37.60879838063664, 126.9862714844579 37.60993863667942, 126.9867716987864 37.61040105655533, 126.9869596606811 37.61057482215976, 126.987068092777 37.61355197137193, 126.9866970327305 37.61468379283731, 126.9853413218618 37.61554542739916, 126.9845404034313 37.61587165062719, 126.9839756453184 37.61610167384227, 126.983243293835 37.61631929720404, 126.9828058746508 37.6166936891581, 126.982019193894 37.61871274006239, 126.9818005329071 37.61930541628534, 126.9820844977698 37.61992295343913, 126.9813736137946 37.62173377522717, 126.9808700629808 37.62275225912288, 126.9801711110254 37.6235525673367, 126.9792086885588 37.62457121153248, 126.9794377030683 37.62695639142638, 126.9794835037773 37.62716032283384, 126.9796664572043 37.62797478525102, 126.9801329740683 37.6283510868893, 126.9812029901815 37.62834884450842, 126.9821631477504 37.62747200481313, 126.9856071643942 37.62362596235604, 126.9864948686617 37.62307324786808, 126.9922455692026 37.61922521995476, 126.9926823617275 37.61887161041287, 126.9935266963475 37.61811811225305, 126.9929933914753 37.61780936662154, 126.9926346774356 37.61702929275015, 126.993124175921 37.61492338783302, 126.9943029302909 37.61330152612908, 126.994555170937 37.61317754582168, 126.9951270474509 37.61322393422046, 126.9954564929762 37.61341011800198, 126.9954674084257 37.61349838786001, 126.9954860373833 37.61364909949461, 126.9975605686985 37.61549555785055, 126.9978971649541 37.61567387851461, 126.9997086532264 37.61663135946261, 127.0004771669448 37.6167179891219, 127.0006938141673 37.61672679274135, 127.000821269686 37.61672958532288, 127.0025154017713 37.61638859707697, 127.0027573272852 37.61632940722625, 127.0029183081001 37.61629002088515, 127.0057550382795 37.61525976153065, 127.0079994975705 37.61221240237145, 127.0089986912388 37.60866084038557)))"
117,서울특별시,성북구,정릉4동,11290650,26898,13006,13892,"MULTIPOLYGON (((126.9931943091371 37.63202771759239, 126.9932477084311 37.63183462810404, 126.9933359164266 37.63151569010014, 126.9940447945922 37.6299863409082, 126.9941018192886 37.62991910226745, 126.994156661622 37.62989877788583, 126.9943333110273 37.6298333408384, 126.9945493730487 37.62982863325569, 126.9989359408159 37.62687856060225, 127.0017386411036 37.62570967564925, 127.0023577234525 37.62559511423878, 127.0028982093342 37.62537318900672, 127.0045014592644 37.62443804688376, 127.006435749455 37.62434248169435, 127.0075688522735 37.62402952543562, 127.0078756766242 37.62390909317402, 127.0078236050472 37.62331962548837, 127.0076471919486 37.62289976675889, 127.0075432803533 37.6226537181697, 127.0074769274266 37.62255648415717, 127.0074422694983 37.62250570224467, 127.0074066285229 37.6224716721165, 127.0073747156479 37.62244109615154, 127.0075059204654 37.62101650445691, 127.0080458287363 37.61936930494954, 127.0084936891561 37.61857461210494, 127.0085568293426 37.6185636263597, 127.0094390295952 37.61816727344713, 127.0114702302027 37.61641925019858, 127.0147523815127 37.61559229237353, 127.0149411841366 37.61541843384156, 127.0152531405185 37.61480787300652, 127.014432729292 37.61357190921508, 127.0134157672988 37.61161412844427, 127.0119759156326 37.61027713785473, 127.0116148330253 37.60957302861353, 127.0115814261201 37.60840969646697, 127.0105304921173 37.60809597840574, 127.0098288979962 37.60834964229412, 127.0089986912388 37.60866084038557, 127.0079994975705 37.61221240237145, 127.0057550382795 37.61525976153065, 127.0029183081001 37.61629002088515, 127.0027573272852 37.61632940722625, 127.0025154017713 37.61638859707697, 127.000821269686 37.61672958532288, 127.0006938141673 37.61672679274135, 127.0004771669448 37.6167179891219, 126.9997086532264 37.61663135946261, 126.9978971649541 37.61567387851461, 126.9975605686985 37.61549555785055, 126.9954860373833 37.61364909949461, 126.9954674084257 37.61349838786001, 126.9954564929762 37.61341011800198, 126.9951270474509 37.61322393422046, 126.994555170937 37.61317754582168, 126.9943029302909 37.61330152612908, 126.993124175921 37.61492338783302, 126.9926346774356 37.61702929275015, 126.9929933914753 37.61780936662154, 126.9935266963475 37.61811811225305, 126.9926823617275 37.61887161041287, 126.9922455692026 37.61922521995476, 126.9864948686617 37.62307324786808, 126.9856071643942 37.62362596235604, 126.9821631477504 37.62747200481313, 126.9812029901815 37.62834884450842, 126.9801329740683 37.6283510868893, 126.9804968759252 37.62864543417669, 126.980508194942 37.62905446496831, 126.9800923123734 37.62927233505252, 126.9795240353134 37.62920222934059, 126.9782133569714 37.62843593611979, 126.9766720613351 37.6288448527654, 126.9763545802853 37.629271579388, 126.9764855443147 37.63008899733446, 126.9750746678809 37.63138628651299, 126.9767170894633 37.63262503271115, 126.9785351297968 37.63384988645762, 126.9835947861339 37.63645446973018, 126.9836572771359 37.63646335550443, 126.9846253882821 37.63656487056026, 126.9849461960249 37.6361708227445, 126.985216797121 37.6358632959921, 126.9856036197749 37.63544473496523, 126.9860559591547 37.63519545055517, 126.9918249564268 37.63230811044217, 126.9931943091371 37.63202771759239)))"
118,서울특별시,성북구,길음1동,11290660,37263,17772,19491,"MULTIPOLYGON (((127.0220295465139 37.6122870292313, 127.0222349805678 37.61126924609166, 127.0222368867174 37.61120400569231, 127.0229285352716 37.60919680268678, 127.0237563589319 37.60682454741243, 127.0242159754029 37.60555946087975, 127.0245936167787 37.60499338029867, 127.0249065242179 37.60453133222418, 127.0250560813383 37.6043210109866, 127.0251144181203 37.60424035924436, 127.0253029480973 37.60398874174101, 127.0253493708468 37.60392696113988, 127.0254489310981 37.60379498129844, 127.0254900392304 37.60374049817273, 127.0259666281073 37.60317891367602, 127.0216393298334 37.60156623588291, 127.0194873162128 37.6023789514552, 127.0177722060704 37.60383540293202, 127.0164042245264 37.60766163640255, 127.0157650055221 37.60996438420794, 127.0146011702583 37.61194574642968, 127.014432729292 37.61357190921508, 127.0152531405185 37.61480787300652, 127.0163109646923 37.6149609826272, 127.0176426861996 37.61457097936299, 127.0192583317251 37.61375284532067, 127.0197923672509 37.61325566768178, 127.0203809793716 37.61261834351325, 127.0204791574903 37.61254776186849, 127.0206054003262 37.61251785451325, 127.0206670961621 37.61250345833265, 127.0220295465139 37.6122870292313)))"
119,서울특별시,성북구,길음2동,11290685,16545,8050,8495,"MULTIPOLYGON (((127.0299826159379 37.61234180727328, 127.0304111487613 37.60913890026055, 127.0321753556362 37.60345507116969, 127.0302197253746 37.60399827577248, 127.0259666281073 37.60317891367602, 127.0254900392304 37.60374049817273, 127.0254489310981 37.60379498129844, 127.0253493708468 37.60392696113988, 127.0253029480973 37.60398874174101, 127.0251144181203 37.60424035924436, 127.0250560813383 37.6043210109866, 127.0249065242179 37.60453133222418, 127.0245936167787 37.60499338029867, 127.0242159754029 37.60555946087975, 127.0237563589319 37.60682454741243, 127.0229285352716 37.60919680268678, 127.0222368867174 37.61120400569231, 127.0222349805678 37.61126924609166, 127.0272228061671 37.6125637004021, 127.0299826159379 37.61234180727328)))"
120,서울특별시,성북구,월곡1동,11290715,27698,13399,14299,"MULTIPOLYGON (((127.043598670337 37.61142710178378, 127.043154929589 37.61068406680491, 127.0430765923876 37.61052490192741, 127.0425528288555 37.60921254622286, 127.0424182887674 37.60759411543776, 127.0404019835058 37.60615201758019, 127.0386235525854 37.6053011968294, 127.0386021923216 37.60532026595873, 127.0383235668728 37.60549605315674, 127.0370610425745 37.60595080493125, 127.036965814216 37.60596963895733, 127.0368768008469 37.60598723992246, 127.0371297047774 37.60492579574508, 127.0376253028123 37.60333348775497, 127.0385225976158 37.60249427617353, 127.0321753556362 37.60345507116969, 127.0304111487613 37.60913890026055, 127.0371034020589 37.61271103786459, 127.0372703594396 37.61270868126688, 127.0390557751499 37.61179480452613, 127.0405154488264 37.61107266320109, 127.0407547944069 37.61104212901909, 127.0408839692728 37.61102565035485, 127.0410717375125 37.61100835386973, 127.0417971909944 37.61095596563507, 127.0419849060756 37.61094542755629, 127.043598670337 37.61142710178378)))"
121,서울특별시,성북구,월곡2동,11290725,20571,9982,10589,"MULTIPOLYGON (((127.0454357356164 37.61128775213215, 127.0453819017522 37.60977217088512, 127.0453817091805 37.60968654259957, 127.0454042502649 37.60958973600687, 127.0454200206195 37.60955824976454, 127.0454443842379 37.60951102222278, 127.0466137051923 37.60837890018433, 127.0473609792871 37.60783287795037, 127.0480447257843 37.60785465200475, 127.0482917824366 37.60786573800446, 127.0483724366615 37.6078773134755, 127.0492819739118 37.60828021901217, 127.0501446706496 37.60884513924781, 127.0501963440638 37.60896589081737, 127.0502965522234 37.60913978121165, 127.0503175895783 37.60917591508822, 127.0515758374952 37.60994927789804, 127.0518959805645 37.60964836296056, 127.052418157649 37.60912643904534, 127.0524184125846 37.60908389752939, 127.0524185237198 37.6090530630106, 127.0523919991979 37.60900127940728, 127.0523443952353 37.60890983787191, 127.0517694044514 37.60810552322764, 127.0507203579286 37.6075460842086, 127.0505677058485 37.60685478300177, 127.05060305192 37.60678170149792, 127.0506211057854 37.60674682516991, 127.0506575827625 37.6066872500755, 127.0511314957251 37.60594657203384, 127.0512856400895 37.60576237381712, 127.0515320035403 37.60555044901862, 127.0516079547047 37.60548982482577, 127.0516984349609 37.60539665418316, 127.0519316817908 37.60511361678564, 127.052159143015 37.60473140916549, 127.052250899907 37.60407152313747, 127.0522389137832 37.6028589900667, 127.0516097819201 37.60199937838619, 127.0513273845387 37.60162650166031, 127.0510088535296 37.60156938532575, 127.050273405968 37.60110534307088, 127.0481580021938 37.5975561070469, 127.0477669425513 37.59666002479961, 127.0476473912901 37.5962876358017, 127.0435174311994 37.59690618222339, 127.0407538027052 37.59580029601416, 127.0408044213536 37.59916764929719, 127.0408045457937 37.5992414067624, 127.0407972961177 37.59943854755507, 127.0407922725034 37.59956471616528, 127.040714542697 37.59988439080193, 127.0406870771223 37.59997554498614, 127.0406676061923 37.60003405656138, 127.0405818017247 37.60028497218824, 127.0405166084944 37.60041422167456, 127.0404721431933 37.60050199447198, 127.040366984214 37.60067622033831, 127.0403217310548 37.60073437906048, 127.0402114012632 37.60087616330527, 127.0399917991185 37.60112761981613, 127.0385225976158 37.60249427617353, 127.0376253028123 37.60333348775497, 127.0371297047774 37.60492579574508, 127.0368768008469 37.60598723992246, 127.036965814216 37.60596963895733, 127.0370610425745 37.60595080493125, 127.0383235668728 37.60549605315674, 127.0386021923216 37.60532026595873, 127.0386235525854 37.6053011968294, 127.0404019835058 37.60615201758019, 127.0424182887674 37.60759411543776, 127.0425528288555 37.60921254622286, 127.0430765923876 37.61052490192741, 127.043154929589 37.61068406680491, 127.043598670337 37.61142710178378, 127.0445478081831 37.61072737831728, 127.0454357356164 37.61128775213215)))"
122,서울특별시,성북구,장위1동,11290760,20857,10225,10632,"MULTIPOLYGON (((127.0503853472475 37.61746963445796, 127.0501947044996 37.61734949278256, 127.0499280376021 37.61717834778022, 127.0495633215219 37.61694373403517, 127.0494542127928 37.61685668505353, 127.0492320767269 37.61667770006547, 127.0490961213836 37.61655662620284, 127.048627154582 37.61611204921764, 127.048596187715 37.61607445297616, 127.0485529882512 37.61602163133482, 127.0484988167759 37.61595143489637, 127.0484634036496 37.61590524083415, 127.0484011328174 37.6157753084814, 127.0483697034511 37.61558941264959, 127.0483581065623 37.61551836686976, 127.0483616631086 37.61527954563604, 127.0483806538367 37.61506780298625, 127.0483927815955 37.61493602815273, 127.0484353816288 37.61479986321525, 127.0485716477473 37.61451646187129, 127.048668473083 37.61431515696962, 127.0487043096424 37.61424431334484, 127.0488062214975 37.6140430457982, 127.0488734548268 37.61391033686602, 127.049018433104 37.61359091457631, 127.0490379093078 37.61354793730172, 127.0490600781261 37.61349643460304, 127.0488940837954 37.61260572477994, 127.0488616056825 37.61247152506185, 127.0488435514503 37.61240125139282, 127.04831200017 37.61201649908712, 127.047542213565 37.61164278210203, 127.0454357356164 37.61128775213215, 127.0445478081831 37.61072737831728, 127.043598670337 37.61142710178378, 127.0419849060756 37.61094542755629, 127.0417971909944 37.61095596563507, 127.0410717375125 37.61100835386973, 127.0408839692728 37.61102565035485, 127.0407547944069 37.61104212901909, 127.0405154488264 37.61107266320109, 127.0390557751499 37.61179480452613, 127.0372703594396 37.61270868126688, 127.0371034020589 37.61271103786459, 127.0391185606465 37.6163085183367, 127.0401944080742 37.61594541776228, 127.0423137600647 37.61747347882891, 127.0430372221136 37.61800137881255, 127.0439136037495 37.61864134155827, 127.0439608449856 37.61867645110973, 127.0445481198522 37.61934344934262, 127.0446800275121 37.6194933196243, 127.0447290016373 37.61954915287617, 127.046079361163 37.61874996670954, 127.0462199441447 37.61866693505137, 127.0462783743135 37.61863243105405, 127.0464616464453 37.6185244158173, 127.0467304070621 37.6183660192405, 127.0469615064791 37.61879129423514, 127.0470470357039 37.61894071342483, 127.0471525748737 37.61905491282094, 127.0472613191494 37.61916234272734, 127.0474860041707 37.61931082262154, 127.0493324071996 37.62046029994936, 127.0493626894678 37.62043069928651, 127.049504163204 37.62029199130055, 127.0503853472475 37.61746963445796)))"
123,서울특별시,성북구,장위2동,11290770,14207,7068,7139,"MULTIPOLYGON (((127.0606680504924 37.61279996911433, 127.0517694044514 37.60810552322764, 127.0523443952353 37.60890983787191, 127.0523919991979 37.60900127940728, 127.0524185237198 37.6090530630106, 127.0524184125846 37.60908389752939, 127.052418157649 37.60912643904534, 127.0518959805645 37.60964836296056, 127.0515758374952 37.60994927789804, 127.0503175895783 37.60917591508822, 127.0502965522234 37.60913978121165, 127.0501963440638 37.60896589081737, 127.0501446706496 37.60884513924781, 127.0492819739118 37.60828021901217, 127.0483724366615 37.6078773134755, 127.0482917824366 37.60786573800446, 127.0480447257843 37.60785465200475, 127.0473609792871 37.60783287795037, 127.0466137051923 37.60837890018433, 127.0454443842379 37.60951102222278, 127.0454200206195 37.60955824976454, 127.0454042502649 37.60958973600687, 127.0453817091805 37.60968654259957, 127.0453819017522 37.60977217088512, 127.0454357356164 37.61128775213215, 127.047542213565 37.61164278210203, 127.04831200017 37.61201649908712, 127.0488435514503 37.61240125139282, 127.0488616056825 37.61247152506185, 127.0488940837954 37.61260572477994, 127.0490600781261 37.61349643460304, 127.0490379093078 37.61354793730172, 127.049018433104 37.61359091457631, 127.0488734548268 37.61391033686602, 127.0488062214975 37.6140430457982, 127.0487043096424 37.61424431334484, 127.048668473083 37.61431515696962, 127.0485716477473 37.61451646187129, 127.0484353816288 37.61479986321525, 127.0483927815955 37.61493602815273, 127.0483806538367 37.61506780298625, 127.0483616631086 37.61527954563604, 127.0483581065623 37.61551836686976, 127.0483697034511 37.61558941264959, 127.0484011328174 37.6157753084814, 127.0484634036496 37.61590524083415, 127.0484988167759 37.61595143489637, 127.0485529882512 37.61602163133482, 127.048596187715 37.61607445297616, 127.048627154582 37.61611204921764, 127.0490961213836 37.61655662620284, 127.0492320767269 37.61667770006547, 127.0494542127928 37.61685668505353, 127.0495633215219 37.61694373403517, 127.0499280376021 37.61717834778022, 127.0501947044996 37.61734949278256, 127.0503853472475 37.61746963445796, 127.0545996277656 37.61501030990834, 127.0550394473655 37.61521703437079, 127.0554663773479 37.61487613342089, 127.0565832976609 37.61390012506076, 127.0573040719142 37.61320654422359, 127.0579703006656 37.61256309454788, 127.0582249042813 37.6123311861023, 127.0606680504924 37.61279996911433)))"
124,서울특별시,성북구,장위3동,11290780,13710,6900,6810,"MULTIPOLYGON (((127.0628925772738 37.614343915584, 127.0606680504924 37.61279996911433, 127.0582249042813 37.6123311861023, 127.0579703006656 37.61256309454788, 127.0573040719142 37.61320654422359, 127.0565832976609 37.61390012506076, 127.0554663773479 37.61487613342089, 127.0550394473655 37.61521703437079, 127.0545996277656 37.61501030990834, 127.0503853472475 37.61746963445796, 127.049504163204 37.62029199130055, 127.0493626894678 37.62043069928651, 127.0493324071996 37.62046029994936, 127.0474860041707 37.61931082262154, 127.0472613191494 37.61916234272734, 127.0471525748737 37.61905491282094, 127.0470470357039 37.61894071342483, 127.0469615064791 37.61879129423514, 127.0467304070621 37.6183660192405, 127.0464616464453 37.6185244158173, 127.0462783743135 37.61863243105405, 127.0462199441447 37.61866693505137, 127.046079361163 37.61874996670954, 127.0447290016373 37.61954915287617, 127.0479239107866 37.62322125511057, 127.0499862497827 37.62443094627259, 127.0511054068133 37.6232454792849, 127.052169737963 37.62209468058838, 127.0527221100569 37.62152540572225, 127.0533532611913 37.62090150859793, 127.0537318603156 37.62057519086872, 127.0538447161169 37.62047877302363, 127.0539621439419 37.62038045700041, 127.0542081923639 37.62017465517391, 127.056909093675 37.61811524061525, 127.0606059962732 37.61565138341141, 127.060911108333 37.61494721882661, 127.0612306731954 37.61477131623737, 127.0614617172088 37.61464618995371, 127.0615157090982 37.61461709696164, 127.0617170282977 37.61451957148898, 127.0620142620348 37.61437558597575, 127.062209970092 37.6143323717486, 127.062421979586 37.61428583761001, 127.062743322727 37.6143140690092, 127.0628925772738 37.614343915584)))"
125,서울특별시,성북구,성북동,11290525,17671,8267,9404,"MULTIPOLYGON (((126.9995592859183 37.60160772501445, 126.999799239074 37.60167149279376, 127.0006445677668 37.60165272823399, 127.0009435694918 37.60150081885615, 127.0009644800233 37.60147572377178, 127.0011484260152 37.60125494246453, 127.0029257295185 37.59889641712006, 127.0029390604743 37.59795682334006, 127.0047005277164 37.59676892968123, 127.0059204663541 37.59667591369166, 127.0069483315327 37.59659233112155, 127.0072463516857 37.59649217460777, 127.0078507444203 37.59598994410914, 127.0081027918431 37.59555947666733, 127.0084191381333 37.59460987722787, 127.0085017347026 37.5941077221173, 127.0084225698365 37.59312042099191, 127.0081830693211 37.59272170527142, 127.00815068931 37.59269340334556, 127.007828274147 37.59252193068153, 127.0076955003331 37.59247292971737, 127.0076573606005 37.59245925047057, 127.0074860115501 37.59224784644476, 127.0074698905532 37.59222411889534, 127.007225070807 37.59185751731858, 127.0074886570355 37.59163156262304, 127.009531179565 37.59206377620858, 127.0115447434885 37.5939659879073, 127.0132614984154 37.59180531164771, 127.0069579281718 37.58869992213672, 127.0062070409653 37.58837540521808, 127.0050446951916 37.5879286409916, 127.004194817617 37.58795048303252, 127.0034198794376 37.58835502962636, 127.0024304919374 37.58905729163966, 127.0023856324952 37.58910399946759, 127.0023378187786 37.58915379544608, 127.0016582518405 37.59010184631106, 127.0016981053348 37.59060226050966, 127.0017869920184 37.59086177213, 127.0019118430581 37.59124875027647, 127.0016812280189 37.59175253032394, 127.0015812851388 37.59188963716848, 127.0015597672751 37.5919187660639, 127.0009421942903 37.59239265541499, 127.0007859970764 37.59244503534296, 127.0006245265884 37.59245336571912, 126.9993720050733 37.59236681171856, 126.9989741586568 37.59247115853042, 126.9987451786228 37.59251637926506, 126.9985321547677 37.59250646095414, 126.9891359030894 37.59130668631862, 126.9890750481001 37.59139446162827, 126.9894757920867 37.5917950211998, 126.9891094507173 37.59195341550093, 126.9887608091341 37.59210400307575, 126.9875262282025 37.5922468001901, 126.9864798407838 37.59250646566559, 126.9857592771792 37.59279401160435, 126.9853287258072 37.59300572621492, 126.9852868081408 37.59302635633529, 126.9852253598527 37.5930571567418, 126.9846787672401 37.59333123147103, 126.9842734961909 37.59358183735348, 126.9840115836973 37.59375538189762, 126.983868097928 37.59385046812643, 126.98337258457 37.59435192551688, 126.982689386493 37.5950655194224, 126.9826523154141 37.59510477354859, 126.9823501148414 37.59545290805665, 126.9821934238158 37.59563342662802, 126.9820114258903 37.59584331683295, 126.981566847345 37.59716526193013, 126.9815664510535 37.59803838498007, 126.98156656448 37.59914365527767, 126.9822275986892 37.59928401269243, 126.9826736950306 37.59937835556374, 126.9827239066743 37.59938871484209, 126.9828973735987 37.59939269279064, 126.9849085265396 37.59943882994709, 126.9863746854395 37.60007953917753, 126.9877411917167 37.60121553576545, 126.9878876056661 37.601336703119, 126.9894704711552 37.60252659458047, 126.9939254657319 37.60274858491162, 126.9944354636542 37.60257387336773, 126.9949378652085 37.60266278764521, 126.9951380053007 37.60269744430056, 126.9952040559209 37.6027003407264, 126.9952519743591 37.60270243849443, 126.9954192687897 37.60267386025694, 126.9972819143287 37.60207903668346, 126.9995592859183 37.60160772501445)))"
126,서울특별시,성북구,삼선동,11290555,26599,12723,13876,"MULTIPOLYGON (((127.0189641329387 37.58882833244873, 127.0187755264737 37.58867443597123, 127.0172924567512 37.58748961750423, 127.0165210981058 37.58686699309067, 127.0146857094254 37.58454413142786, 127.0146641329499 37.58448658194645, 127.0146858848304 37.58222654740629, 127.0138277921009 37.58170812346521, 127.0131223864201 37.58143931902778, 127.012801219237 37.58131747945706, 127.0121550244591 37.58150517845035, 127.0104800653117 37.58033548115759, 127.0099654330849 37.58020835714158, 127.0088413178392 37.58045263873488, 127.0073325396313 37.58320333921623, 127.0073549368092 37.58336333585895, 127.007149932 37.58405894053222, 127.0065274937981 37.58612822121334, 127.0059333543167 37.58690990576036, 127.0057356691429 37.58693611847661, 127.0056086132096 37.58695248658489, 127.0055408341663 37.58696121612009, 127.0051246853577 37.58694595193991, 127.0047032100521 37.58698587130248, 127.0046092171449 37.58699522489745, 127.0042997472868 37.58708670556748, 127.0041638899187 37.58729006506221, 127.00418355846 37.58771354437431, 127.0041861961394 37.58777010851341, 127.004194817617 37.58795048303252, 127.0050446951916 37.5879286409916, 127.0062070409653 37.58837540521808, 127.0069579281718 37.58869992213672, 127.0132614984154 37.59180531164771, 127.0133820328179 37.59187057203551, 127.0137963299108 37.59209486633394, 127.0140330992069 37.59217757531637, 127.0140802836109 37.59219405686954, 127.0144122754883 37.59230921788967, 127.0149959148468 37.59237583927739, 127.0154239648925 37.59241590455829, 127.0165118525593 37.59242322046816, 127.0165835385792 37.59209842896341, 127.0166438847757 37.59182311892749, 127.0167017144953 37.59155923209594, 127.0167680550563 37.59125767863333, 127.0168178859387 37.59103336404458, 127.0168613565029 37.5908466968867, 127.016960343256 37.59042797682391, 127.0169934303773 37.59035371524634, 127.0170788598007 37.59028574288779, 127.0176921735153 37.58979777493047, 127.0177207016516 37.58977529839364, 127.0177946368436 37.5897170725523, 127.0179824566406 37.58957362455936, 127.0186035265992 37.58910182653417, 127.0189641329387 37.58882833244873)))"
127,서울특별시,성북구,동선동,11290575,16460,6821,9639,"MULTIPOLYGON (((127.0197225150752 37.59728835527325, 127.0214774279756 37.59710456087421, 127.0219710035833 37.59698199710697, 127.0220781719109 37.59660043622031, 127.0225307170053 37.59570097354779, 127.0225690510959 37.5956388232195, 127.0244872966719 37.59430390242731, 127.0247919443478 37.5941575342839, 127.0249932389109 37.59412913921373, 127.024464327476 37.59357372102119, 127.0238820568131 37.59251229396126, 127.0238404269598 37.59239523065813, 127.0237881701208 37.59224827193234, 127.0237074925849 37.59124294718458, 127.0237298159903 37.59096249373135, 127.0221136192338 37.58907327628792, 127.0219010588421 37.58910170920575, 127.0216261444762 37.5891389024933, 127.021325716187 37.58918049839718, 127.0201785684579 37.58933695605252, 127.0196613301812 37.58940696166017, 127.0189641329387 37.58882833244873, 127.0186035265992 37.58910182653417, 127.0179824566406 37.58957362455936, 127.0177946368436 37.5897170725523, 127.0177207016516 37.58977529839364, 127.0176921735153 37.58979777493047, 127.0170788598007 37.59028574288779, 127.0169934303773 37.59035371524634, 127.016960343256 37.59042797682391, 127.0168613565029 37.5908466968867, 127.0168178859387 37.59103336404458, 127.0167680550563 37.59125767863333, 127.0167017144953 37.59155923209594, 127.0166438847757 37.59182311892749, 127.0165835385792 37.59209842896341, 127.0165118525593 37.59242322046816, 127.0154239648925 37.59241590455829, 127.0149959148468 37.59237583927739, 127.0144122754883 37.59230921788967, 127.0140802836109 37.59219405686954, 127.0140330992069 37.59217757531637, 127.0137963299108 37.59209486633394, 127.0133820328179 37.59187057203551, 127.0132614984154 37.59180531164771, 127.0115447434885 37.5939659879073, 127.0134233472709 37.59523113291316, 127.0130660236616 37.59578915031513, 127.0126698080477 37.59668031379478, 127.0128871280058 37.59820560966027, 127.0133399138829 37.59825817630806, 127.0140169300119 37.59833035139047, 127.0150564626051 37.59841135863238, 127.0161518654741 37.59688166875825, 127.0182346441679 37.59690708900683, 127.0194879528297 37.59710486042732, 127.0197225150752 37.59728835527325)))"
128,서울특별시,성북구,종암동,11290705,42391,20633,21758,"MULTIPOLYGON (((127.0321753556362 37.60345507116969, 127.0385225976158 37.60249427617353, 127.0399917991185 37.60112761981613, 127.0402114012632 37.60087616330527, 127.0403217310548 37.60073437906048, 127.040366984214 37.60067622033831, 127.0404721431933 37.60050199447198, 127.0405166084944 37.60041422167456, 127.0405818017247 37.60028497218824, 127.0406676061923 37.60003405656138, 127.0406870771223 37.59997554498614, 127.040714542697 37.59988439080193, 127.0407922725034 37.59956471616528, 127.0407972961177 37.59943854755507, 127.0408045457937 37.5992414067624, 127.0408044213536 37.59916764929719, 127.0407538027052 37.59580029601416, 127.0390627541217 37.59127014721531, 127.0364883094785 37.59124586018718, 127.0364975156522 37.5913434831689, 127.0363639257001 37.59160883545215, 127.0359268581543 37.59224366924932, 127.0355405147248 37.59255198688858, 127.035334077508 37.5924856916529, 127.0351374307179 37.5924225217227, 127.0347463249266 37.59221056624732, 127.0343567304835 37.59199637559475, 127.0342599657455 37.59193932174656, 127.0339530540326 37.59179197975218, 127.0335393421326 37.59160782312912, 127.0333190200456 37.5915182778909, 127.0332258070018 37.59148039532386, 127.0320300509465 37.59114554376117, 127.0318157187276 37.59111652675382, 127.0302610412393 37.59124987700547, 127.0249932389109 37.59412913921373, 127.025335562186 37.59450271028933, 127.0257019215789 37.5949025501829, 127.0259881011393 37.5963300768595, 127.0259126002736 37.59673537838021, 127.0260617944453 37.59765985500562, 127.0263034672244 37.59896101347057, 127.0267821524207 37.60020249738221, 127.0271198061784 37.60075345388685, 127.0292041988989 37.60302359437552, 127.0302197253746 37.60399827577248, 127.0321753556362 37.60345507116969)))"
129,서울특별시,성북구,석관동,11290810,36558,18094,18464,"MULTIPOLYGON (((127.0714031371484 37.6156279752979, 127.0714587400475 37.61428027888826, 127.0717177603203 37.6068117515544, 127.0693552107858 37.60933156792092, 127.0688732382814 37.60932980814445, 127.0685882657387 37.60932246543619, 127.068734389877 37.60687113867245, 127.0681011504813 37.60650789692986, 127.0662463975172 37.60582057098255, 127.064972936501 37.60587447100198, 127.0623345955003 37.60528110417022, 127.062139951897 37.60513615905444, 127.061668509318 37.60462965644957, 127.0607733621091 37.60356950262505, 127.0600456334621 37.60209985451751, 127.057255966424 37.6012522988318, 127.0520299418043 37.59995268207152, 127.0513273845387 37.60162650166031, 127.0516097819201 37.60199937838619, 127.0522389137832 37.6028589900667, 127.052250899907 37.60407152313747, 127.052159143015 37.60473140916549, 127.0519316817908 37.60511361678564, 127.0516984349609 37.60539665418316, 127.0516079547047 37.60548982482577, 127.0515320035403 37.60555044901862, 127.0512856400895 37.60576237381712, 127.0511314957251 37.60594657203384, 127.0506575827625 37.6066872500755, 127.0506211057854 37.60674682516991, 127.05060305192 37.60678170149792, 127.0505677058485 37.60685478300177, 127.0507203579286 37.6075460842086, 127.0517694044514 37.60810552322764, 127.0606680504924 37.61279996911433, 127.0628925772738 37.614343915584, 127.064866325532 37.61422203862331, 127.0659437238152 37.61428194467599, 127.0660519415174 37.61430486632415, 127.0677483707991 37.61522145827175, 127.0680119786241 37.61543761906754, 127.0680085723875 37.61553675426199, 127.0680069739077 37.61556823410262, 127.0711870608496 37.61636856878375, 127.0714031371484 37.6156279752979)))"
130,서울특별시,강북구,번1동,11305595,19815,9806,10009,"MULTIPOLYGON (((127.0364398584365 37.63688688183034, 127.0384793084214 37.63391366891164, 127.0378985442212 37.63401506769303, 127.0374276614219 37.63409773200237, 127.0372864210194 37.63412513769497, 127.035973930297 37.63446833239313, 127.0358602390896 37.63450151413815, 127.03578729861 37.6345228052189, 127.0357496246254 37.63454293709994, 127.0357010900729 37.63456898407765, 127.0356266733563 37.63460892695541, 127.0355989441398 37.63462459123647, 127.0348275949696 37.63507109512616, 127.0344898942324 37.6352669309639, 127.0342863749223 37.63535725309924, 127.0342533585428 37.63537190471846, 127.0340463162295 37.63540376074141, 127.0338556029961 37.63540977194744, 127.0338217975862 37.63541064968182, 127.0335936956809 37.63539859232062, 127.0317498300394 37.63528312917558, 127.0315239571931 37.63526871245079, 127.0312803842038 37.63525197163148, 127.0274917376431 37.63496307804532, 127.0232548583827 37.63465084213414, 127.0235828778618 37.63608980385038, 127.025301978941 37.63744782671254, 127.0308330478805 37.64285637818275, 127.0312503509729 37.6426247934739, 127.0316977132288 37.64234602892804, 127.0317887511463 37.64228893001972, 127.0322868672508 37.64193600430563, 127.0326706156267 37.64163107035845, 127.0329110505982 37.64132034277609, 127.0329354289633 37.641288739256, 127.0330128763051 37.641164856872, 127.0331499290436 37.64094231827674, 127.0332974624177 37.64062968722545, 127.0335473105458 37.64009888618239, 127.0335774646304 37.64003478509711, 127.0335961096891 37.6399887887403, 127.0338421945569 37.6393891216457, 127.0338861115182 37.63928221173713, 127.0339680824182 37.6390831641636, 127.0340241597788 37.63895156501669, 127.0342375520935 37.63845242655292, 127.0342665116849 37.63838519291237, 127.0343045224853 37.63829694875226, 127.0343569737518 37.63817772850931, 127.0345013903281 37.63785156340764, 127.0346254299092 37.63768297977168, 127.0346857290028 37.63760104262158, 127.0349633983221 37.63737680291023, 127.0354961834211 37.63713666712863, 127.0355301831374 37.63712254181469, 127.035698412952 37.63708112951721, 127.0358821333175 37.63703656013972, 127.0360914505345 37.63698578175851, 127.0364398584365 37.63688688183034)))"
131,서울특별시,강북구,번2동,11305603,17307,8407,8900,"MULTIPOLYGON (((127.0384793084214 37.63391366891164, 127.0414812112738 37.63127886172986, 127.0419667853362 37.6309889022168, 127.0415208309594 37.63059172651327, 127.0406198123308 37.62979053663821, 127.0398003330235 37.62909556526675, 127.0393817751455 37.62874241143771, 127.0388230228219 37.62827774613201, 127.0384706364416 37.62800019334096, 127.0368993427054 37.62667707227506, 127.036874979913 37.62664840418442, 127.0368162724619 37.62657704001179, 127.036739279101 37.62642914336747, 127.0367344590742 37.62629279680537, 127.0367681301466 37.62619018437747, 127.0367828343787 37.62614539233754, 127.037010960141 37.62556942027512, 127.0374808866263 37.62436685759915, 127.037597107216 37.62378369536853, 127.0376308028234 37.62360355937184, 127.0376736658349 37.62331529754886, 127.0376025107091 37.6216542990967, 127.0375884750221 37.62151637505045, 127.0375764685943 37.62139844167164, 127.0373246408568 37.62077890955025, 127.036825489328 37.61995560464067, 127.0347117510484 37.62092975012068, 127.034579158864 37.62101700876809, 127.0344735103868 37.62108654505014, 127.0338308980821 37.62248784569098, 127.0325924404923 37.62550795159084, 127.032604275311 37.62553177581363, 127.0327838770809 37.62592006318969, 127.0327925727408 37.62611501232636, 127.0327495906004 37.62631836461868, 127.032406979842 37.62762998867198, 127.032106420902 37.62800848641356, 127.0318503729629 37.62817759858231, 127.0314213843957 37.62859051178994, 127.0313196592381 37.6287042623779, 127.0312979750644 37.62872860253549, 127.0300207651554 37.63054658033942, 127.0298240599907 37.63085440606506, 127.0297603448352 37.63096231280776, 127.029009814867 37.63304704483561, 127.0275708559238 37.6335011808653, 127.0274917376431 37.63496307804532, 127.0312803842038 37.63525197163148, 127.0315239571931 37.63526871245079, 127.0317498300394 37.63528312917558, 127.0335936956809 37.63539859232062, 127.0338217975862 37.63541064968182, 127.0338556029961 37.63540977194744, 127.0340463162295 37.63540376074141, 127.0342533585428 37.63537190471846, 127.0342863749223 37.63535725309924, 127.0344898942324 37.6352669309639, 127.0348275949696 37.63507109512616, 127.0355989441398 37.63462459123647, 127.0356266733563 37.63460892695541, 127.0357010900729 37.63456898407765, 127.0357496246254 37.63454293709994, 127.03578729861 37.6345228052189, 127.0358602390896 37.63450151413815, 127.035973930297 37.63446833239313, 127.0372864210194 37.63412513769497, 127.0374276614219 37.63409773200237, 127.0378985442212 37.63401506769303, 127.0384793084214 37.63391366891164)))"
132,서울특별시,강북구,번3동,11305608,18506,8723,9783,"MULTIPOLYGON (((127.0499862497827 37.62443094627259, 127.0479239107866 37.62322125511057, 127.0447290016373 37.61954915287617, 127.0446800275121 37.6194933196243, 127.0445481198522 37.61934344934262, 127.0439608449856 37.61867645110973, 127.0439136037495 37.61864134155827, 127.0430372221136 37.61800137881255, 127.0423137600647 37.61747347882891, 127.0401944080742 37.61594541776228, 127.0391185606465 37.6163085183367, 127.0389028526008 37.61637640294172, 127.0387367672887 37.61643546861787, 127.0387110631956 37.61646916753952, 127.0386518490967 37.61654773581604, 127.0384906587148 37.61741133312925, 127.0384895264887 37.61752668234336, 127.0384887375289 37.61760849399385, 127.0385136254645 37.61782040649333, 127.0385353960655 37.61796470620824, 127.0385830682768 37.61827247526669, 127.0386648524009 37.61856122416199, 127.0387076579614 37.61871046429189, 127.0387182314244 37.61874730106801, 127.0388483039372 37.61890107077843, 127.0388998336208 37.61904323334527, 127.0387945201447 37.61946870535387, 127.0379061176838 37.61974577202957, 127.036825489328 37.61995560464067, 127.0373246408568 37.62077890955025, 127.0375764685943 37.62139844167164, 127.0375884750221 37.62151637505045, 127.0376025107091 37.6216542990967, 127.0376736658349 37.62331529754886, 127.0376308028234 37.62360355937184, 127.037597107216 37.62378369536853, 127.0374808866263 37.62436685759915, 127.037010960141 37.62556942027512, 127.0367828343787 37.62614539233754, 127.0367681301466 37.62619018437747, 127.0367344590742 37.62629279680537, 127.036739279101 37.62642914336747, 127.0368162724619 37.62657704001179, 127.036874979913 37.62664840418442, 127.0368993427054 37.62667707227506, 127.0384706364416 37.62800019334096, 127.0388230228219 37.62827774613201, 127.0393817751455 37.62874241143771, 127.0398003330235 37.62909556526675, 127.0406198123308 37.62979053663821, 127.0415208309594 37.63059172651327, 127.0419667853362 37.6309889022168, 127.0421563972672 37.6308757908823, 127.0428931432496 37.63043590057197, 127.0461649238287 37.62809043681942, 127.0482431384028 37.62646750941026, 127.0499862497827 37.62443094627259)))"
133,서울특별시,강북구,수유1동,11305615,21961,10849,11112,"MULTIPOLYGON (((127.0225882946006 37.63033637310363, 127.0212346787878 37.63011907371077, 127.0177635384067 37.62930161977255, 127.0158793354212 37.62745967946733, 127.0100859101764 37.62523987917, 127.009206833243 37.6250424380728, 127.0082179744036 37.62495156694004, 127.0078117042653 37.62503004707906, 127.0076584436191 37.62505964760977, 127.0071361380872 37.62510591406314, 127.0064730670877 37.62512567602302, 127.0054378759179 37.62486671342594, 127.0045014592644 37.62443804688376, 127.0028982093342 37.62537318900672, 127.0023577234525 37.62559511423878, 127.0017386411036 37.62570967564925, 126.9989359408159 37.62687856060225, 126.9945493730487 37.62982863325569, 126.9943333110273 37.6298333408384, 126.994156661622 37.62989877788583, 126.9941018192886 37.62991910226745, 126.9940447945922 37.6299863409082, 126.9933359164266 37.63151569010014, 126.9932477084311 37.63183462810404, 126.9931943091371 37.63202771759239, 126.9976106410353 37.63204885835184, 127.0003657153641 37.63210111749692, 127.0025978807687 37.63228292966746, 127.0030735784623 37.63234577892906, 127.0081251815818 37.63301365206595, 127.0109198020988 37.63341622480782, 127.011710757678 37.63356484339135, 127.0120319698313 37.63362363079019, 127.0125153939089 37.63368083610146, 127.013149575102 37.63375421869908, 127.0132690603122 37.63376718619345, 127.0145879980268 37.63390344909214, 127.0146835702125 37.63391285563279, 127.0150375251102 37.63394698454556, 127.0192156363465 37.63434940612073, 127.0207263603895 37.63449075329866, 127.0219546334448 37.63456895204313, 127.0225284003193 37.63460509361616, 127.0232548583827 37.63465084213414, 127.0234324940209 37.63323871491934, 127.0225882946006 37.63033637310363)))"
134,서울특별시,강북구,수유2동,11305625,22021,10589,11432,"MULTIPOLYGON (((127.0156184129697 37.6491031073647, 127.0163402980296 37.64889987607642, 127.0169989028958 37.64872681398044, 127.0174549749266 37.64864531584939, 127.0176265464863 37.6486291084661, 127.0177901159673 37.64861535581083, 127.0179624653527 37.64861470817286, 127.0182040680727 37.64861456847272, 127.0185756551375 37.6486712922899, 127.0187879577547 37.64870933858913, 127.0188668060008 37.64872406353985, 127.0189266610871 37.64873525436372, 127.0191827059662 37.64880108173133, 127.0197103586624 37.64893843151188, 127.0199550278262 37.64901153424305, 127.0202316934147 37.64906786655239, 127.0204873689681 37.64908129944813, 127.0205574923383 37.64908496446896, 127.0207713772121 37.64906058711734, 127.0208381050603 37.64905284529343, 127.021139603803 37.64901634861971, 127.0213135265824 37.64896410100037, 127.024617275767 37.64740237571813, 127.0247805891758 37.6472351598407, 127.0251516955964 37.64660111748124, 127.0241167280324 37.6453498175562, 127.0239734528334 37.64437579608359, 127.0239502658461 37.64368054663573, 127.0208235259134 37.64142130636719, 127.0205440613942 37.64125455120248, 127.0204458047405 37.64122035081334, 127.020207600958 37.64113826199821, 127.0198601171776 37.64108276811925, 127.0198056109358 37.64107691292378, 127.0177797029699 37.64088477782271, 127.0169148071002 37.64081395830064, 127.0159244576071 37.6443069902996, 127.0138964127453 37.64905207152703, 127.0151826722879 37.64910919147367, 127.0156184129697 37.6491031073647)))"
135,서울특별시,강북구,수유3동,11305635,24277,12079,12198,"MULTIPOLYGON (((127.0308330478805 37.64285637818275, 127.025301978941 37.63744782671254, 127.0235828778618 37.63608980385038, 127.0228948216275 37.63623574420111, 127.0225638009426 37.63626933197726, 127.0224023137486 37.63627431174431, 127.0220997200206 37.63628322649839, 127.0217832125495 37.63626279060387, 127.0215214237224 37.63621440897976, 127.0214849666742 37.63620487819693, 127.0213594717087 37.63617206520274, 127.0211077233958 37.63610456996688, 127.02059805137 37.63594590349258, 127.0205605418211 37.6359333468635, 127.0198579384549 37.63569726851012, 127.019802143832 37.63567225464791, 127.0196408636883 37.63559982459333, 127.019516211863 37.63554372701133, 127.0171816070819 37.63725915814409, 127.0169148071002 37.64081395830064, 127.0177797029699 37.64088477782271, 127.0198056109358 37.64107691292378, 127.0198601171776 37.64108276811925, 127.020207600958 37.64113826199821, 127.0204458047405 37.64122035081334, 127.0205440613942 37.64125455120248, 127.0208235259134 37.64142130636719, 127.0239502658461 37.64368054663573, 127.0239734528334 37.64437579608359, 127.0241167280324 37.6453498175562, 127.0251516955964 37.64660111748124, 127.0254957052559 37.64607982121414, 127.0256385920482 37.64589224186791, 127.0256610658222 37.64586282247725, 127.0259209333857 37.64572324955665, 127.0260904397131 37.64563646491354, 127.026163302844 37.64559916284561, 127.0265954327455 37.64538119692448, 127.0266423116337 37.64536223163031, 127.027081266047 37.64518485144151, 127.0272655890468 37.64511890931107, 127.0279143910171 37.6447481917498, 127.0297222324875 37.64363947608873, 127.0297656227361 37.64361260893811, 127.02993422449 37.64350061372961, 127.0301263088171 37.64337293840912, 127.0306058083396 37.64305374588955, 127.0308330478805 37.64285637818275)))"
136,서울특별시,강북구,삼양동,11305534,25776,12787,12989,"MULTIPOLYGON (((127.0220050760834 37.62518060489079, 127.018404301724 37.62486285455343, 127.0184370006586 37.62460275960964, 127.018472063166 37.62432686750027, 127.0185620281141 37.62403980195058, 127.0185811934531 37.62398931049305, 127.018674812079 37.62374971076621, 127.0188270294078 37.6235206576451, 127.0205928019907 37.62098702658192, 127.0210875284493 37.61946810691285, 127.02028511359 37.61971375985847, 127.020038380337 37.61975500956663, 127.0193297974858 37.61986817105461, 127.0192131964065 37.61988290524047, 127.018939663555 37.61990770395585, 127.0188298291627 37.61991739621151, 127.0177647661757 37.62001106822787, 127.0149979449946 37.62019915090119, 127.0148852835934 37.62020657451242, 127.0148349847818 37.62020974774088, 127.0146840803075 37.6202170139146, 127.0143964540285 37.62023047737446, 127.0133872756061 37.62022519332454, 127.0085568293426 37.6185636263597, 127.0084936891561 37.61857461210494, 127.0080458287363 37.61936930494954, 127.0075059204654 37.62101650445691, 127.0073747156479 37.62244109615154, 127.0074066285229 37.6224716721165, 127.0074422694983 37.62250570224467, 127.0074769274266 37.62255648415717, 127.0075432803533 37.6226537181697, 127.0076471919486 37.62289976675889, 127.0078236050472 37.62331962548837, 127.0078756766242 37.62390909317402, 127.0075688522735 37.62402952543562, 127.006435749455 37.62434248169435, 127.0045014592644 37.62443804688376, 127.0054378759179 37.62486671342594, 127.0064730670877 37.62512567602302, 127.0071361380872 37.62510591406314, 127.0076584436191 37.62505964760977, 127.0078117042653 37.62503004707906, 127.0082179744036 37.62495156694004, 127.009206833243 37.6250424380728, 127.0100859101764 37.62523987917, 127.0158793354212 37.62745967946733, 127.0177635384067 37.62930161977255, 127.0212346787878 37.63011907371077, 127.0225882946006 37.63033637310363, 127.0208566339765 37.62912635493883, 127.0220050760834 37.62518060489079)))"
137,서울특별시,강북구,미아동,11305535,22987,10986,12001,"MULTIPOLYGON (((127.0325924404923 37.62550795159084, 127.0323504937589 37.62569159541512, 127.0268946133866 37.62445670580971, 127.0258556253237 37.62367062316412, 127.022871051811 37.62295329415381, 127.0225094937415 37.62383176453076, 127.0223497485999 37.62422432740213, 127.0220699801782 37.62499947323219, 127.0220050760834 37.62518060489079, 127.0208566339765 37.62912635493883, 127.0225882946006 37.63033637310363, 127.0234324940209 37.63323871491934, 127.0232548583827 37.63465084213414, 127.0274917376431 37.63496307804532, 127.0275708559238 37.6335011808653, 127.029009814867 37.63304704483561, 127.0297603448352 37.63096231280776, 127.0298240599907 37.63085440606506, 127.0300207651554 37.63054658033942, 127.0312979750644 37.62872860253549, 127.0313196592381 37.6287042623779, 127.0314213843957 37.62859051178994, 127.0318503729629 37.62817759858231, 127.032106420902 37.62800848641356, 127.032406979842 37.62762998867198, 127.0327495906004 37.62631836461868, 127.0327925727408 37.62611501232636, 127.0327838770809 37.62592006318969, 127.032604275311 37.62553177581363, 127.0325924404923 37.62550795159084)))"
138,서울특별시,강북구,송중동,11305545,29000,13986,15014,"MULTIPOLYGON (((127.0325924404923 37.62550795159084, 127.0338308980821 37.62248784569098, 127.0344735103868 37.62108654505014, 127.034579158864 37.62101700876809, 127.0347117510484 37.62092975012068, 127.036825489328 37.61995560464067, 127.0379061176838 37.61974577202957, 127.0387945201447 37.61946870535387, 127.0388998336208 37.61904323334527, 127.0388483039372 37.61890107077843, 127.0387182314244 37.61874730106801, 127.0387076579614 37.61871046429189, 127.0386648524009 37.61856122416199, 127.0385830682768 37.61827247526669, 127.0385353960655 37.61796470620824, 127.0385136254645 37.61782040649333, 127.0384887375289 37.61760849399385, 127.0384895264887 37.61752668234336, 127.0384906587148 37.61741133312925, 127.0386518490967 37.61654773581604, 127.0387110631956 37.61646916753952, 127.0387367672887 37.61643546861787, 127.0389028526008 37.61637640294172, 127.0391185606465 37.6163085183367, 127.0371034020589 37.61271103786459, 127.0304111487613 37.60913890026055, 127.0299826159379 37.61234180727328, 127.0299459772166 37.61486849824232, 127.0298818247522 37.61617293403982, 127.0298393699908 37.61683748497519, 127.0298071319108 37.61712467698054, 127.0289300396018 37.6193367465158, 127.0268946133866 37.62445670580971, 127.0323504937589 37.62569159541512, 127.0325924404923 37.62550795159084)))"
139,서울특별시,강북구,송천동,11305555,28911,14343,14568,"MULTIPOLYGON (((127.0268946133866 37.62445670580971, 127.0289300396018 37.6193367465158, 127.0298071319108 37.61712467698054, 127.0298393699908 37.61683748497519, 127.0298818247522 37.61617293403982, 127.0299459772166 37.61486849824232, 127.0299826159379 37.61234180727328, 127.0272228061671 37.6125637004021, 127.0222349805678 37.61126924609166, 127.0220295465139 37.6122870292313, 127.0222136443213 37.61450394752227, 127.0222161989498 37.61532305151081, 127.0222007237238 37.61552804391573, 127.0221013061019 37.61590169780265, 127.0218810454814 37.61672436967104, 127.0218123696211 37.61696297372246, 127.0210875284493 37.61946810691285, 127.0205928019907 37.62098702658192, 127.0188270294078 37.6235206576451, 127.018674812079 37.62374971076621, 127.0185811934531 37.62398931049305, 127.0185620281141 37.62403980195058, 127.018472063166 37.62432686750027, 127.0184370006586 37.62460275960964, 127.018404301724 37.62486285455343, 127.0220050760834 37.62518060489079, 127.0220699801782 37.62499947323219, 127.0223497485999 37.62422432740213, 127.0225094937415 37.62383176453076, 127.022871051811 37.62295329415381, 127.0258556253237 37.62367062316412, 127.0268946133866 37.62445670580971)))"
140,서울특별시,강북구,삼각산동,11305575,33100,15899,17201,"MULTIPOLYGON (((127.0210875284493 37.61946810691285, 127.0218123696211 37.61696297372246, 127.0218810454814 37.61672436967104, 127.0221013061019 37.61590169780265, 127.0222007237238 37.61552804391573, 127.0222161989498 37.61532305151081, 127.0222136443213 37.61450394752227, 127.0220295465139 37.6122870292313, 127.0206670961621 37.61250345833265, 127.0206054003262 37.61251785451325, 127.0204791574903 37.61254776186849, 127.0203809793716 37.61261834351325, 127.0197923672509 37.61325566768178, 127.0192583317251 37.61375284532067, 127.0176426861996 37.61457097936299, 127.0163109646923 37.6149609826272, 127.0152531405185 37.61480787300652, 127.0149411841366 37.61541843384156, 127.0147523815127 37.61559229237353, 127.0114702302027 37.61641925019858, 127.0094390295952 37.61816727344713, 127.0085568293426 37.6185636263597, 127.0133872756061 37.62022519332454, 127.0143964540285 37.62023047737446, 127.0146840803075 37.6202170139146, 127.0148349847818 37.62020974774088, 127.0148852835934 37.62020657451242, 127.0149979449946 37.62019915090119, 127.0177647661757 37.62001106822787, 127.0188298291627 37.61991739621151, 127.018939663555 37.61990770395585, 127.0192131964065 37.61988290524047, 127.0193297974858 37.61986817105461, 127.020038380337 37.61975500956663, 127.02028511359 37.61971375985847, 127.0210875284493 37.61946810691285)))"
141,서울특별시,강북구,우이동,11305645,21401,10440,10961,"MULTIPOLYGON (((127.0082924711403 37.68467769374363, 127.0084061790736 37.68129929272439, 127.0103648410288 37.67953857946782, 127.0104484929527 37.67953973793205, 127.0104942979638 37.67953881942163, 127.0105647652993 37.67953152267595, 127.0107357427849 37.67950631884586, 127.0119519059983 37.67930743176571, 127.0119810596183 37.679294032443, 127.0120210678052 37.6792457514541, 127.012774410386 37.67806812249259, 127.0132152570622 37.67723829363987, 127.0134155280806 37.67644960793933, 127.0138672051198 37.67537201798417, 127.0141190064333 37.67501590296276, 127.0145829967662 37.67440040135528, 127.0148211354457 37.67424308033669, 127.0157358265134 37.67345073821441, 127.0166318579237 37.6726669921937, 127.0173181808403 37.67182543500856, 127.0173856100041 37.67174272528323, 127.0184402954662 37.67007845276057, 127.0185161323551 37.66995830919259, 127.0184732485348 37.66964405578783, 127.0184396756802 37.66939804420544, 127.0181609161712 37.66877723955884, 127.0176305121108 37.66827821191819, 127.016925721895 37.66789676770846, 127.0165544680535 37.66755386681614, 127.0158276014672 37.66686361903643, 127.0156578919827 37.66669842902076, 127.0155160900521 37.6663425502205, 127.0154452137604 37.66616464239787, 127.0154069438014 37.665838878624, 127.0154388584506 37.66376369005558, 127.0154498940024 37.66348111329675, 127.0163353005371 37.66157600210437, 127.0158469627987 37.6614440633515, 127.0151624469151 37.66159146712259, 127.0146279471819 37.66089284443453, 127.0142757023798 37.65989105724171, 127.0137902972675 37.65848072398298, 127.0126613440047 37.65330936643181, 127.0125629408458 37.65274993033521, 127.0125471297801 37.65245805781144, 127.012555213042 37.65222300501987, 127.0126425314188 37.65184667084097, 127.012692818737 37.65163168483169, 127.0128955894911 37.65117734803457, 127.0129085264273 37.65114923472813, 127.0132447051217 37.65043985731184, 127.0152011914503 37.64931206808114, 127.0152883143922 37.6492640784462, 127.0153839242094 37.64921141863894, 127.0156184129697 37.6491031073647, 127.0151826722879 37.64910919147367, 127.0138964127453 37.64905207152703, 127.0159244576071 37.6443069902996, 127.0106609383378 37.64503156368944, 127.0073434469467 37.64498690376212, 127.0062700859147 37.64478074261463, 127.0045732870235 37.64436014131233, 127.0042869511967 37.64416515128374, 127.0040732836023 37.64401665952287, 127.0036222029689 37.64368914582663, 127.0034598975005 37.64357129814879, 127.0032011679422 37.6433798016737, 127.0018763944614 37.642104458341, 127.0005623983629 37.64070746520788, 126.9982294616171 37.63956638896052, 126.996956212221 37.63897284487342, 126.9967322274953 37.638886262665, 126.9965086380085 37.6388470018839, 126.9948632266565 37.63871265466781, 126.9915131609039 37.63872079703807, 126.9892646259313 37.63945581357009, 126.9884207941416 37.63978339858301, 126.9863674703017 37.6406509135974, 126.9858948636918 37.64056897420316, 126.9842614664231 37.64176850919146, 126.9841138737982 37.64190644423866, 126.9840432956104 37.6419860119515, 126.9839774947199 37.64206020151647, 126.9839197432654 37.64212741386508, 126.9838839427953 37.64216907922091, 126.9832662123216 37.64359780845904, 126.9832488706658 37.64364674260645, 126.9832435296419 37.64370187191699, 126.983324303507 37.64380255332667, 126.9834494591405 37.64393942834371, 126.9836159570191 37.64403666320216, 126.983758510114 37.64411992149885, 126.9842023969475 37.64447225712927, 126.9847797034409 37.64550906184431, 126.9849433081877 37.64582411683296, 126.98496191285 37.64590081153319, 126.9849641476141 37.64598757478249, 126.9846422571764 37.64745872488037, 126.9846168403912 37.64754762064928, 126.9837022970774 37.64978456467066, 126.9836313092404 37.6499059341016, 126.9835149817218 37.65002823165746, 126.9822435620315 37.65130480615087, 126.9820953263521 37.65142921554953, 126.9809941436479 37.65289963417085, 126.9797040019063 37.65479081648343, 126.979643831835 37.65488405540832, 126.9794479850424 37.65573720469107, 126.9794480586693 37.6558273383455, 126.9795458306933 37.65603169641687, 126.9795703285992 37.65607574449736, 126.9796543235438 37.65622370836165, 126.9797847289918 37.6564225768393, 126.9799536638099 37.65658330837626, 126.9812863172042 37.65742065589698, 126.9814219129288 37.65748547206908, 126.9816936690014 37.65753398644714, 126.9830699978361 37.65810786577304, 126.9846379018066 37.65905774606458, 126.9848480747834 37.65920062407392, 126.9849961743396 37.6593026707282, 126.9861772270844 37.66066432730875, 126.9864103352254 37.66097630231712, 126.9866404562596 37.6614144504334, 126.9880189627277 37.66333802695061, 126.9893685546714 37.66380243007044, 126.9898419533982 37.66390249841773, 126.9924313664776 37.66483077523539, 126.9928446150757 37.66502408592706, 126.9941556158441 37.66627693413485, 126.9942569639539 37.66648354847951, 126.9935514993978 37.67324099570699, 126.9929856598221 37.67741574623184, 126.9929573933702 37.67761166318998, 126.9927570394896 37.67841073328442, 126.992571656367 37.67878173817097, 126.9917363276643 37.67946543249626, 126.9930716143809 37.67988688743197, 126.9937992044603 37.68024941799903, 126.9938450583583 37.68028228801913, 126.9958093084165 37.6819299949112, 126.9971368668484 37.68305733288691, 126.9973532127882 37.68327844103517, 126.9975363202335 37.68345632360894, 126.9976630679403 37.68357945342078, 126.9977412382017 37.68365414606644, 126.997910661134 37.68379430320338, 126.9979860603816 37.68382418780207, 127.0036382554869 37.68509983444255, 127.0038640781542 37.68514359785946, 127.0041906624607 37.68517313790674, 127.0056505189022 37.6852265862836, 127.0057547174234 37.68522589636222, 127.0058618298388 37.68521507859844, 127.006148634303 37.68514980691217, 127.0063584992115 37.68509958016592, 127.0065696384035 37.6850490429112, 127.006655644893 37.68502782490133, 127.0082924711403 37.68467769374363)))"
142,서울특별시,강북구,인수동,11305660,32813,15890,16923,"MULTIPOLYGON (((127.0159244576071 37.6443069902996, 127.0169148071002 37.64081395830064, 127.0171816070819 37.63725915814409, 127.019516211863 37.63554372701133, 127.0196408636883 37.63559982459333, 127.019802143832 37.63567225464791, 127.0198579384549 37.63569726851012, 127.0205605418211 37.6359333468635, 127.02059805137 37.63594590349258, 127.0211077233958 37.63610456996688, 127.0213594717087 37.63617206520274, 127.0214849666742 37.63620487819693, 127.0215214237224 37.63621440897976, 127.0217832125495 37.63626279060387, 127.0220997200206 37.63628322649839, 127.0224023137486 37.63627431174431, 127.0225638009426 37.63626933197726, 127.0228948216275 37.63623574420111, 127.0235828778618 37.63608980385038, 127.0232548583827 37.63465084213414, 127.0225284003193 37.63460509361616, 127.0219546334448 37.63456895204313, 127.0207263603895 37.63449075329866, 127.0192156363465 37.63434940612073, 127.0150375251102 37.63394698454556, 127.0146835702125 37.63391285563279, 127.0145879980268 37.63390344909214, 127.0132690603122 37.63376718619345, 127.013149575102 37.63375421869908, 127.0125153939089 37.63368083610146, 127.0120319698313 37.63362363079019, 127.011710757678 37.63356484339135, 127.0109198020988 37.63341622480782, 127.0081251815818 37.63301365206595, 127.0030735784623 37.63234577892906, 127.0025978807687 37.63228292966746, 127.0003657153641 37.63210111749692, 126.9976106410353 37.63204885835184, 126.9931943091371 37.63202771759239, 126.9918249564268 37.63230811044217, 126.9860559591547 37.63519545055517, 126.9856036197749 37.63544473496523, 126.985216797121 37.6358632959921, 126.9849461960249 37.6361708227445, 126.9846253882821 37.63656487056026, 126.9863674703017 37.6406509135974, 126.9884207941416 37.63978339858301, 126.9892646259313 37.63945581357009, 126.9915131609039 37.63872079703807, 126.9948632266565 37.63871265466781, 126.9965086380085 37.6388470018839, 126.9967322274953 37.638886262665, 126.996956212221 37.63897284487342, 126.9982294616171 37.63956638896052, 127.0005623983629 37.64070746520788, 127.0018763944614 37.642104458341, 127.0032011679422 37.6433798016737, 127.0034598975005 37.64357129814879, 127.0036222029689 37.64368914582663, 127.0040732836023 37.64401665952287, 127.0042869511967 37.64416515128374, 127.0045732870235 37.64436014131233, 127.0062700859147 37.64478074261463, 127.0073434469467 37.64498690376212, 127.0106609383378 37.64503156368944, 127.0159244576071 37.6443069902996)))"
143,서울특별시,도봉구,쌍문1동,11320660,22528,10857,11671,"MULTIPOLYGON (((127.0163353005371 37.66157600210437, 127.0171942987736 37.66002021362051, 127.018462670569 37.65750166250445, 127.0189259385192 37.65686473194182, 127.020558720161 37.65484784341294, 127.0208718596834 37.65457611217238, 127.0209206421004 37.65453726537224, 127.0218734051533 37.65424256372287, 127.0219573082131 37.65422402800829, 127.02203655442 37.6542139314933, 127.0221031560536 37.65421420133002, 127.0221738861237 37.65423364122138, 127.0222223993963 37.65427204531223, 127.0222641446435 37.65430160691713, 127.0223925989756 37.65437986721479, 127.0224809430623 37.65441402492997, 127.0228949120022 37.65438640657187, 127.0230274775938 37.65437680264172, 127.0245920662831 37.65424679157507, 127.0254650406752 37.65401708606638, 127.0257119088756 37.65397075879071, 127.0269477839008 37.65371996832278, 127.0276185579432 37.65353112255578, 127.0280504394421 37.65313513697876, 127.0286729427893 37.65071188836658, 127.0251516955964 37.64660111748124, 127.0247805891758 37.6472351598407, 127.024617275767 37.64740237571813, 127.0213135265824 37.64896410100037, 127.021139603803 37.64901634861971, 127.0208381050603 37.64905284529343, 127.0207713772121 37.64906058711734, 127.0205574923383 37.64908496446896, 127.0204873689681 37.64908129944813, 127.0202316934147 37.64906786655239, 127.0199550278262 37.64901153424305, 127.0197103586624 37.64893843151188, 127.0191827059662 37.64880108173133, 127.0189266610871 37.64873525436372, 127.0188668060008 37.64872406353985, 127.0187879577547 37.64870933858913, 127.0185756551375 37.6486712922899, 127.0182040680727 37.64861456847272, 127.0179624653527 37.64861470817286, 127.0177901159673 37.64861535581083, 127.0176265464863 37.6486291084661, 127.0174549749266 37.64864531584939, 127.0169989028958 37.64872681398044, 127.0163402980296 37.64889987607642, 127.0156184129697 37.6491031073647, 127.0153839242094 37.64921141863894, 127.0152883143922 37.6492640784462, 127.0152011914503 37.64931206808114, 127.0132447051217 37.65043985731184, 127.0129085264273 37.65114923472813, 127.0128955894911 37.65117734803457, 127.012692818737 37.65163168483169, 127.0126425314188 37.65184667084097, 127.012555213042 37.65222300501987, 127.0125471297801 37.65245805781144, 127.0125629408458 37.65274993033521, 127.0126613440047 37.65330936643181, 127.0137902972675 37.65848072398298, 127.0142757023798 37.65989105724171, 127.0146279471819 37.66089284443453, 127.0151624469151 37.66159146712259, 127.0158469627987 37.6614440633515, 127.0163353005371 37.66157600210437)))"
144,서울특별시,도봉구,쌍문2동,11320670,20133,9783,10350,"MULTIPOLYGON (((127.0422216669942 37.66170859913057, 127.0422025850098 37.66164218594848, 127.0420586326068 37.66114125126786, 127.0420084512176 37.66100472957376, 127.0419436147517 37.66082854630153, 127.0419161241843 37.66076948775061, 127.0417296938899 37.66036949305794, 127.0372115696599 37.65283682899629, 127.036331426395 37.65137319077052, 127.0332948087886 37.65114377439792, 127.0329468780124 37.65261044348203, 127.0330501964656 37.65319559396598, 127.0330655087588 37.6532395946848, 127.0335500915636 37.65381611408304, 127.0336221937194 37.65387742858944, 127.0336938698442 37.6539383628065, 127.0337805223134 37.65398998138036, 127.0338385768404 37.65402456160561, 127.0343823189677 37.65670254723604, 127.0341774025656 37.65952549407307, 127.0337850981637 37.66008244714332, 127.0349103717637 37.66032464422997, 127.0377542761822 37.66175088941332, 127.0422216669942 37.66170859913057)))"
145,서울특별시,도봉구,쌍문3동,11320680,17325,8335,8990,"MULTIPOLYGON (((127.0334675777095 37.64650482413778, 127.0309846283283 37.6429938354013, 127.0308330478805 37.64285637818275, 127.0306058083396 37.64305374588955, 127.0301263088171 37.64337293840912, 127.02993422449 37.64350061372961, 127.0297656227361 37.64361260893811, 127.0297222324875 37.64363947608873, 127.0279143910171 37.6447481917498, 127.0272655890468 37.64511890931107, 127.027081266047 37.64518485144151, 127.0266423116337 37.64536223163031, 127.0265954327455 37.64538119692448, 127.026163302844 37.64559916284561, 127.0260904397131 37.64563646491354, 127.0259209333857 37.64572324955665, 127.0256610658222 37.64586282247725, 127.0256385920482 37.64589224186791, 127.0254957052559 37.64607982121414, 127.0251516955964 37.64660111748124, 127.0286729427893 37.65071188836658, 127.0332948087886 37.65114377439792, 127.036331426395 37.65137319077052, 127.0334675777095 37.64650482413778)))"
146,서울특별시,도봉구,쌍문4동,11320681,19946,9500,10446,"MULTIPOLYGON (((127.0332948087886 37.65114377439792, 127.0286729427893 37.65071188836658, 127.0280504394421 37.65313513697876, 127.0276185579432 37.65353112255578, 127.0269477839008 37.65371996832278, 127.0257119088756 37.65397075879071, 127.0254650406752 37.65401708606638, 127.0260721588126 37.65670990985842, 127.0277729966805 37.65880910554363, 127.0278053837168 37.65882495897559, 127.028017700513 37.65892875912735, 127.0281748390915 37.65900557757968, 127.0298123941781 37.65956756369895, 127.029911245941 37.65959819745802, 127.0299891981655 37.65962234838591, 127.0300588500215 37.65963411791195, 127.0301258064659 37.65964542599277, 127.0302278034832 37.65964583584928, 127.0303917072325 37.65961831818053, 127.0327772739712 37.65977651245447, 127.0337850981637 37.66008244714332, 127.0341774025656 37.65952549407307, 127.0343823189677 37.65670254723604, 127.0338385768404 37.65402456160561, 127.0337805223134 37.65398998138036, 127.0336938698442 37.6539383628065, 127.0336221937194 37.65387742858944, 127.0335500915636 37.65381611408304, 127.0330655087588 37.6532395946848, 127.0330501964656 37.65319559396598, 127.0329468780124 37.65261044348203, 127.0332948087886 37.65114377439792)))"
147,서울특별시,도봉구,방학1동,11320690,30344,15009,15335,"MULTIPOLYGON (((127.0436473744994 37.66981596056299, 127.0488230556478 37.66909342765484, 127.0488868741077 37.66874327739212, 127.0490133991119 37.66806920937042, 127.0492769876309 37.66739952808896, 127.049287775318 37.66737252929413, 127.0496657763181 37.66662361256924, 127.0497166684124 37.66655721630399, 127.0497579145605 37.66650341088594, 127.0497914920737 37.66645959901744, 127.0500622060655 37.66610573169422, 127.0506083921243 37.66531463980874, 127.0508472559588 37.66495388923534, 127.0510479668308 37.66457383958274, 127.0511265089684 37.66435894491136, 127.0512662954931 37.66397528297286, 127.0513249316754 37.66365215226944, 127.0514706872939 37.66180497048797, 127.0515512451182 37.66065721043847, 127.0445843415942 37.66203433861612, 127.0422216669942 37.66170859913057, 127.0377542761822 37.66175088941332, 127.0349103717637 37.66032464422997, 127.0347256815824 37.66254004287205, 127.0347057247116 37.66278557770998, 127.0346901828595 37.66297951054599, 127.0346818775035 37.6630858000551, 127.0346842578999 37.66322757127087, 127.0346860241808 37.66332968136203, 127.0346902049101 37.66335559768862, 127.0347195354371 37.66352472704282, 127.0348051640106 37.66376955163408, 127.034935554491 37.6639965259702, 127.0350033524734 37.66407724633303, 127.03514728867 37.66424860744205, 127.0353906595693 37.66443916190681, 127.0360416926374 37.66489963455972, 127.0365858440182 37.66527164775415, 127.0376408206761 37.66599122157512, 127.0377870906291 37.66608767873472, 127.0378933859276 37.66615776381555, 127.0381559858334 37.66633912667817, 127.0390415669737 37.66695099114676, 127.0390939531128 37.66704060816182, 127.0393250075078 37.66833113885397, 127.0394154179625 37.66883849198351, 127.039603465809 37.66996364034487, 127.0436473744994 37.66981596056299)))"
148,서울특별시,도봉구,방학2동,11320700,21268,10725,10543,"MULTIPOLYGON (((127.039603465809 37.66996364034487, 127.0394154179625 37.66883849198351, 127.0393250075078 37.66833113885397, 127.0390939531128 37.66704060816182, 127.0390415669737 37.66695099114676, 127.0381559858334 37.66633912667817, 127.0378933859276 37.66615776381555, 127.0377870906291 37.66608767873472, 127.0376408206761 37.66599122157512, 127.0365858440182 37.66527164775415, 127.0360416926374 37.66489963455972, 127.0353906595693 37.66443916190681, 127.03514728867 37.66424860744205, 127.0350033524734 37.66407724633303, 127.034935554491 37.6639965259702, 127.0348051640106 37.66376955163408, 127.0347195354371 37.66352472704282, 127.0346902049101 37.66335559768862, 127.0346860241808 37.66332968136203, 127.0346842578999 37.66322757127087, 127.0346818775035 37.6630858000551, 127.0346901828595 37.66297951054599, 127.0347057247116 37.66278557770998, 127.0347256815824 37.66254004287205, 127.0330902280135 37.66234935318126, 127.0314723708366 37.66216904722541, 127.0314260641689 37.66220370886004, 127.0313558236587 37.66225630207016, 127.0308132599311 37.66266916895674, 127.0307827458255 37.66271420982027, 127.030752826258 37.6627591773286, 127.0304797502202 37.66341553897504, 127.0305847088388 37.66362777018614, 127.030802169915 37.66386636221438, 127.0308619787048 37.66391865213775, 127.0309290268373 37.6639772801567, 127.030645589284 37.6652132332095, 127.0306296766892 37.66526386990622, 127.030606486422 37.66533711463276, 127.0305211271103 37.66551571216581, 127.0278900112109 37.66811973935909, 127.0271578306178 37.6686401429125, 127.0254392196586 37.66942754027493, 127.022797335423 37.67162289256272, 127.0228922897768 37.67195789635468, 127.0304742769468 37.67463148041618, 127.0312179865537 37.67493300506281, 127.0312813212707 37.67466959457877, 127.0313624474136 37.67458653020641, 127.0315060041737 37.67443954343182, 127.0317179819683 37.67431645207748, 127.0368541995925 37.67157978193788, 127.0372022995807 37.67144594840268, 127.0375756315967 37.67135727940938, 127.0377316867652 37.67152315053723, 127.0381043947395 37.67191930439313, 127.0382943656791 37.67202708148096, 127.0388140208487 37.67211474119433, 127.0392705071813 37.67210300526389, 127.0397632631225 37.67184241588369, 127.0398092111446 37.6717468285449, 127.0397789095211 37.67125886383493, 127.0397448687004 37.67080355871268, 127.0397150214764 37.67062033641809, 127.0396820494827 37.6704179936528, 127.039603465809 37.66996364034487)))"
149,서울특별시,도봉구,방학3동,11320710,28846,14054,14792,"MULTIPOLYGON (((127.0254392196586 37.66942754027493, 127.0271578306178 37.6686401429125, 127.0278900112109 37.66811973935909, 127.0305211271103 37.66551571216581, 127.030606486422 37.66533711463276, 127.0306296766892 37.66526386990622, 127.030645589284 37.6652132332095, 127.0309290268373 37.6639772801567, 127.0308619787048 37.66391865213775, 127.030802169915 37.66386636221438, 127.0305847088388 37.66362777018614, 127.0304797502202 37.66341553897504, 127.030752826258 37.6627591773286, 127.0307827458255 37.66271420982027, 127.0308132599311 37.66266916895674, 127.0313558236587 37.66225630207016, 127.0314260641689 37.66220370886004, 127.0314723708366 37.66216904722541, 127.0330902280135 37.66234935318126, 127.0347256815824 37.66254004287205, 127.0349103717637 37.66032464422997, 127.0337850981637 37.66008244714332, 127.0327772739712 37.65977651245447, 127.0303917072325 37.65961831818053, 127.0302278034832 37.65964583584928, 127.0301258064659 37.65964542599277, 127.0300588500215 37.65963411791195, 127.0299891981655 37.65962234838591, 127.029911245941 37.65959819745802, 127.0298123941781 37.65956756369895, 127.0281748390915 37.65900557757968, 127.028017700513 37.65892875912735, 127.0278053837168 37.65882495897559, 127.0277729966805 37.65880910554363, 127.0260721588126 37.65670990985842, 127.0254650406752 37.65401708606638, 127.0245920662831 37.65424679157507, 127.0230274775938 37.65437680264172, 127.0228949120022 37.65438640657187, 127.0224809430623 37.65441402492997, 127.0223925989756 37.65437986721479, 127.0222641446435 37.65430160691713, 127.0222223993963 37.65427204531223, 127.0221738861237 37.65423364122138, 127.0221031560536 37.65421420133002, 127.02203655442 37.6542139314933, 127.0219573082131 37.65422402800829, 127.0218734051533 37.65424256372287, 127.0209206421004 37.65453726537224, 127.0208718596834 37.65457611217238, 127.020558720161 37.65484784341294, 127.0189259385192 37.65686473194182, 127.018462670569 37.65750166250445, 127.0171942987736 37.66002021362051, 127.0163353005371 37.66157600210437, 127.0154498940024 37.66348111329675, 127.0154388584506 37.66376369005558, 127.0154069438014 37.665838878624, 127.0154452137604 37.66616464239787, 127.0155160900521 37.6663425502205, 127.0156578919827 37.66669842902076, 127.0158276014672 37.66686361903643, 127.0165544680535 37.66755386681614, 127.016925721895 37.66789676770846, 127.0176305121108 37.66827821191819, 127.0181609161712 37.66877723955884, 127.0184396756802 37.66939804420544, 127.0184732485348 37.66964405578783, 127.0185161323551 37.66995830919259, 127.0184402954662 37.67007845276057, 127.0184420644113 37.67011266555099, 127.0184446674353 37.67016081634677, 127.0186240833876 37.67080036810062, 127.0187197707884 37.67092750395319, 127.0187695428349 37.67099362147484, 127.0190429847278 37.6711209233593, 127.0192224617956 37.67119938148758, 127.021563412187 37.67119533103488, 127.0227978535936 37.66954982976186, 127.0254392196586 37.66942754027493)))"
150,서울특별시,도봉구,창1동,11320511,26438,12650,13788,"MULTIPOLYGON (((127.0482973573891 37.65166186810611, 127.0512475154323 37.64519587752931, 127.0505967325711 37.6451472067233, 127.0479963370461 37.641696416249, 127.0463547756851 37.63915622931054, 127.0454688549799 37.63945702112613, 127.0451941253876 37.63955060286987, 127.0450191260141 37.63967048208385, 127.0449407212062 37.63986622070484, 127.0442719602431 37.64261766775629, 127.0436521233477 37.64391838934157, 127.039980662669 37.64637391090859, 127.0334675777095 37.64650482413778, 127.036331426395 37.65137319077052, 127.0415960269262 37.65169355919262, 127.0446624386589 37.65121861435611, 127.0451631219834 37.65114167894356, 127.0453217009118 37.65112566060326, 127.0455054847794 37.65111821172073, 127.0457463476632 37.65112364613308, 127.0459403946359 37.65113791322987, 127.0461223297824 37.65116227344129, 127.0462838623993 37.65119923670498, 127.046382701963 37.65122186179215, 127.0482973573891 37.65166186810611)))"
151,서울특별시,도봉구,창2동,11320512,30723,15088,15635,"MULTIPOLYGON (((127.0436521233477 37.64391838934157, 127.0426215412348 37.64330712234548, 127.0425016145177 37.64322048948903, 127.0422561871485 37.64304319083077, 127.0390025062601 37.63961485802682, 127.0364398584365 37.63688688183034, 127.0360914505345 37.63698578175851, 127.0358821333175 37.63703656013972, 127.035698412952 37.63708112951721, 127.0355301831374 37.63712254181469, 127.0354961834211 37.63713666712863, 127.0349633983221 37.63737680291023, 127.0346857290028 37.63760104262158, 127.0346254299092 37.63768297977168, 127.0345013903281 37.63785156340764, 127.0343569737518 37.63817772850931, 127.0343045224853 37.63829694875226, 127.0342665116849 37.63838519291237, 127.0342375520935 37.63845242655292, 127.0340241597788 37.63895156501669, 127.0339680824182 37.6390831641636, 127.0338861115182 37.63928221173713, 127.0338421945569 37.6393891216457, 127.0335961096891 37.6399887887403, 127.0335774646304 37.64003478509711, 127.0335473105458 37.64009888618239, 127.0332974624177 37.64062968722545, 127.0331499290436 37.64094231827674, 127.0330128763051 37.641164856872, 127.0329354289633 37.641288739256, 127.0329110505982 37.64132034277609, 127.0326706156267 37.64163107035845, 127.0322868672508 37.64193600430563, 127.0317887511463 37.64228893001972, 127.0316977132288 37.64234602892804, 127.0312503509729 37.6426247934739, 127.0308330478805 37.64285637818275, 127.0309846283283 37.6429938354013, 127.0334675777095 37.64650482413778, 127.039980662669 37.64637391090859, 127.0436521233477 37.64391838934157)))"
152,서울특별시,도봉구,창3동,11320513,14923,7446,7477,"MULTIPOLYGON (((127.0463547756851 37.63915622931054, 127.045511426119 37.63782916108731, 127.0452959619486 37.63748693096588, 127.0450142656952 37.63686730150587, 127.044922038414 37.63596106457018, 127.0449179507285 37.63592381901407, 127.0440253884594 37.63361753809455, 127.0439358233289 37.6334369241429, 127.0435285847087 37.63307932042195, 127.042903297508 37.6326961199679, 127.0414812112738 37.63127886172986, 127.0384793084214 37.63391366891164, 127.0364398584365 37.63688688183034, 127.0390025062601 37.63961485802682, 127.0422561871485 37.64304319083077, 127.0425016145177 37.64322048948903, 127.0426215412348 37.64330712234548, 127.0436521233477 37.64391838934157, 127.0442719602431 37.64261766775629, 127.0449407212062 37.63986622070484, 127.0450191260141 37.63967048208385, 127.0451941253876 37.63955060286987, 127.0454688549799 37.63945702112613, 127.0463547756851 37.63915622931054)))"
153,서울특별시,도봉구,창4동,11320514,28034,13520,14514,"MULTIPOLYGON (((127.0515512451182 37.66065721043847, 127.0524350243087 37.65816160704357, 127.0541817443508 37.65448156002282, 127.0542088704457 37.65302169627572, 127.0542181207426 37.65254064208442, 127.0542311517202 37.65213959664602, 127.0542347089319 37.65203948964069, 127.0542379646926 37.65194808840428, 127.0542922305815 37.65092978320251, 127.0543612325222 37.65040839531875, 127.0544082551991 37.65020534856294, 127.0544303290065 37.65011008854238, 127.0545335796458 37.64966769680229, 127.0546334731828 37.64947215039233, 127.0548246354336 37.64909757329347, 127.0550447150647 37.6486657618732, 127.055211778361 37.64833402386896, 127.0553245440921 37.64795814076875, 127.0554720134934 37.64746521447897, 127.0555782805938 37.64710846000215, 127.0558925360127 37.64597057843638, 127.0557321273785 37.64530636478925, 127.0550725023237 37.64163205430179, 127.0549367229935 37.64076175091341, 127.0543713961145 37.64064356962696, 127.0542736702483 37.64063756709279, 127.0541928021617 37.64065760474485, 127.05413035752 37.64067307909147, 127.0540095249625 37.64074022273304, 127.0536181302607 37.64103505740079, 127.0533753688898 37.64123468635299, 127.0532050551061 37.64140078901043, 127.0528919420551 37.6417545046208, 127.0526178710796 37.6420937206894, 127.0523328993847 37.64259626220829, 127.0522474352914 37.64278859882748, 127.0512611927846 37.64515987606064, 127.0512475154323 37.64519587752931, 127.0482973573891 37.65166186810611, 127.0482800589804 37.65169896486391, 127.0472861084106 37.65389892221987, 127.0471818176849 37.65415540266127, 127.0470077457323 37.65458399462254, 127.04679109581 37.65511783572968, 127.0465466497474 37.65572016027457, 127.0463258200437 37.65626349162684, 127.0463064242143 37.65631069207743, 127.0458584975017 37.65737259020449, 127.045660837358 37.6578404999734, 127.0455939283461 37.65799799844532, 127.0452929708317 37.65843060626744, 127.0445843415942 37.66203433861612, 127.0515512451182 37.66065721043847)))"
154,서울특별시,도봉구,창5동,11320515,25866,12452,13414,"MULTIPOLYGON (((127.0482973573891 37.65166186810611, 127.046382701963 37.65122186179215, 127.0462838623993 37.65119923670498, 127.0461223297824 37.65116227344129, 127.0459403946359 37.65113791322987, 127.0457463476632 37.65112364613308, 127.0455054847794 37.65111821172073, 127.0453217009118 37.65112566060326, 127.0451631219834 37.65114167894356, 127.0446624386589 37.65121861435611, 127.0415960269262 37.65169355919262, 127.036331426395 37.65137319077052, 127.0372115696599 37.65283682899629, 127.0417296938899 37.66036949305794, 127.0419161241843 37.66076948775061, 127.0419436147517 37.66082854630153, 127.0420084512176 37.66100472957376, 127.0420586326068 37.66114125126786, 127.0422025850098 37.66164218594848, 127.0422216669942 37.66170859913057, 127.0445843415942 37.66203433861612, 127.0452929708317 37.65843060626744, 127.0455939283461 37.65799799844532, 127.045660837358 37.6578404999734, 127.0458584975017 37.65737259020449, 127.0463064242143 37.65631069207743, 127.0463258200437 37.65626349162684, 127.0465466497474 37.65572016027457, 127.04679109581 37.65511783572968, 127.0470077457323 37.65458399462254, 127.0471818176849 37.65415540266127, 127.0472861084106 37.65389892221987, 127.0482800589804 37.65169896486391, 127.0482973573891 37.65166186810611)))"
155,서울특별시,도봉구,도봉1동,11320521,22431,11330,11101,"MULTIPOLYGON (((127.0450853655148 37.69244158977186, 127.045378152083 37.69064118533486, 127.0453926245258 37.69053533482245, 127.0457765068378 37.68768410306507, 127.046000411303 37.68548922227546, 127.046052453366 37.68497666616771, 127.0460432714284 37.68485495111954, 127.0458829218951 37.68278803085727, 127.045876214484 37.68274324490888, 127.0458427373917 37.6825197299999, 127.0456084079704 37.68096177701688, 127.0455906999645 37.68084453566264, 127.0455818318061 37.68078591492918, 127.0443345108504 37.67344658299234, 127.0436473744994 37.66981596056299, 127.039603465809 37.66996364034487, 127.0396820494827 37.6704179936528, 127.0397150214764 37.67062033641809, 127.0397448687004 37.67080355871268, 127.0397789095211 37.67125886383493, 127.0398092111446 37.6717468285449, 127.0397632631225 37.67184241588369, 127.0392705071813 37.67210300526389, 127.0388140208487 37.67211474119433, 127.0382943656791 37.67202708148096, 127.0381043947395 37.67191930439313, 127.0377316867652 37.67152315053723, 127.0375756315967 37.67135727940938, 127.0372022995807 37.67144594840268, 127.0368541995925 37.67157978193788, 127.0317179819683 37.67431645207748, 127.0315060041737 37.67443954343182, 127.0313624474136 37.67458653020641, 127.0312813212707 37.67466959457877, 127.0312179865537 37.67493300506281, 127.0304742769468 37.67463148041618, 127.0228922897768 37.67195789635468, 127.022797335423 37.67162289256272, 127.0254392196586 37.66942754027493, 127.0227978535936 37.66954982976186, 127.021563412187 37.67119533103488, 127.0192224617956 37.67119938148758, 127.0190429847278 37.6711209233593, 127.0187695428349 37.67099362147484, 127.0187197707884 37.67092750395319, 127.0186240833876 37.67080036810062, 127.0184446674353 37.67016081634677, 127.0184420644113 37.67011266555099, 127.0184402954662 37.67007845276057, 127.0173856100041 37.67174272528323, 127.0173181808403 37.67182543500856, 127.0166318579237 37.6726669921937, 127.0157358265134 37.67345073821441, 127.0148211354457 37.67424308033669, 127.0145829967662 37.67440040135528, 127.0141190064333 37.67501590296276, 127.0138672051198 37.67537201798417, 127.0134155280806 37.67644960793933, 127.0132152570622 37.67723829363987, 127.012774410386 37.67806812249259, 127.0120210678052 37.6792457514541, 127.0119810596183 37.679294032443, 127.0119519059983 37.67930743176571, 127.0107357427849 37.67950631884586, 127.0105647652993 37.67953152267595, 127.0104942979638 37.67953881942163, 127.0104484929527 37.67953973793205, 127.0103648410288 37.67953857946782, 127.0084061790736 37.68129929272439, 127.0082924711403 37.68467769374363, 127.0084016180507 37.68473339759599, 127.0086250381309 37.68486947142058, 127.0086919430657 37.68493622325067, 127.0087045011584 37.68496669545202, 127.0087233214994 37.68501409367487, 127.0087496307769 37.68511253836171, 127.0088077171423 37.68532991067514, 127.0089608686161 37.68661381670415, 127.0089726778616 37.68697193709733, 127.0089679103211 37.68705099089176, 127.0089639981324 37.68710730770118, 127.0087091109923 37.68824304792972, 127.0086860190002 37.68830491812096, 127.008636563907 37.68838808503627, 127.0085500809113 37.68849475752053, 127.0082923702604 37.68873678980049, 127.0081906402761 37.68883009031042, 127.0081390436061 37.68890765532756, 127.0080862004246 37.68902624633318, 127.0080752874869 37.68911582178105, 127.0080551610177 37.69054863482893, 127.0080577239573 37.69059505495206, 127.0088199432762 37.69454717877205, 127.0088372367453 37.69461147045541, 127.0088953512763 37.69472439657989, 127.0090748127887 37.69502136092196, 127.0091295827322 37.6951095450571, 127.0091575438712 37.69515416904348, 127.0092081569533 37.69523493142525, 127.0107450654335 37.69705390731349, 127.0119173116737 37.69821492583559, 127.011948313246 37.69824434731333, 127.0119876034913 37.69825352320709, 127.0120429182248 37.69825289585907, 127.0120957444362 37.69824946407162, 127.0121520279361 37.69824640709528, 127.0121921979822 37.6982442298281, 127.0123416882159 37.69823806115703, 127.0123759628434 37.69823713031838, 127.0127806672739 37.69823990282794, 127.0137944010459 37.69825310038894, 127.0143691240808 37.6982629028947, 127.0144890874108 37.69826835600022, 127.0145273117359 37.69827752665972, 127.0146113808615 37.69832406581271, 127.0149389007904 37.69854511226571, 127.0149775485469 37.69860075248839, 127.0150167517603 37.6986738717331, 127.0158458475253 37.70102523886384, 127.0195677066094 37.70107989967062, 127.0196769981156 37.70095190119881, 127.019792658362 37.70082731304499, 127.0198860333709 37.70075108041041, 127.0202832216543 37.70050708512717, 127.0220898453189 37.69960407992009, 127.0221537240171 37.69959307220095, 127.0246970539642 37.69944674570611, 127.0247750681742 37.69944255350448, 127.0248175501676 37.69944075981267, 127.0248970449929 37.69943741173223, 127.0249664582239 37.69944783133272, 127.0250669578445 37.69947527600885, 127.0253025900739 37.69954607777711, 127.0253952898845 37.69957461743366, 127.0255106077007 37.69961226131631, 127.0256492767542 37.6996578856481, 127.0267765261566 37.70022067513624, 127.0268393857418 37.7002575438492, 127.0268873233759 37.70030054928903, 127.0269490916982 37.70039937987653, 127.0270044881095 37.70049593155035, 127.0270124126998 37.7005216692172, 127.0270367295743 37.70060000023658, 127.0270673075574 37.7006516626285, 127.0271074269122 37.70069688993939, 127.0271519560971 37.70071847505717, 127.02721792617 37.70071310628443, 127.0279558906376 37.70061578921354, 127.0279871353245 37.70060802766907, 127.0280283770136 37.70058903952919, 127.0280721781618 37.70055640198995, 127.0282132982401 37.70038585405734, 127.0288905962473 37.69953515736871, 127.0289952960641 37.6993794925956, 127.0292195846868 37.69900239367671, 127.0292807241639 37.69886462183904, 127.0293008669178 37.69881850916214, 127.0293895367164 37.6985856443309, 127.0296694865738 37.6977034592648, 127.0296965469302 37.69756956215471, 127.0297035711291 37.6974703764138, 127.0297258624182 37.69708402062304, 127.0297265740601 37.69697135736489, 127.0297272115639 37.69675729431849, 127.0296988241241 37.69653748220105, 127.0296971697739 37.69635044986484, 127.0297294016387 37.69618608589092, 127.0298594844111 37.69579452651363, 127.029925857765 37.69561227200471, 127.0300672100658 37.69523202389203, 127.0311443507076 37.6929390486068, 127.0311727102998 37.69289984086306, 127.0324683384129 37.69171225536732, 127.0325004540947 37.69170510445457, 127.0325678137765 37.69170199149089, 127.032821496725 37.69171935861562, 127.0340731160251 37.69188145463701, 127.0341063998705 37.69188609278812, 127.0341595227705 37.69189418928918, 127.0358354599071 37.69222076997664, 127.0358948425088 37.69224353333789, 127.0383794214675 37.69324475908527, 127.0384329448203 37.69327393913331, 127.0385512995413 37.69336372409902, 127.0388523414027 37.6936319206355, 127.0390535816505 37.69387606642197, 127.0396931311703 37.69408925041942, 127.0397523509607 37.69414355683494, 127.0398128797763 37.69421365060894, 127.0400086483273 37.69442622686815, 127.0402304982515 37.69466312772053, 127.0402618760618 37.69468830701666, 127.0403836059659 37.69478146074467, 127.0404295061027 37.69481989206157, 127.0404980818129 37.69484161995498, 127.0405509381432 37.69485660771161, 127.0406191105942 37.69487476469882, 127.0407160805617 37.69489880232088, 127.0407967789638 37.69491826985281, 127.041015848753 37.69503178892611, 127.041433890775 37.69529930752093, 127.0415293510039 37.69534023853002, 127.0415767251269 37.69535957595986, 127.0417228392055 37.69534775061912, 127.0430132578992 37.69520854584172, 127.043122763424 37.69515489039787, 127.0431901414682 37.69503459861105, 127.0431958654675 37.6949095613141, 127.0432065731182 37.69466737047708, 127.0450853655148 37.69244158977186)))"
156,서울특별시,도봉구,도봉2동,11320522,28789,14134,14655,"MULTIPOLYGON (((127.050776586123 37.68702162431446, 127.0509441011908 37.68673047442097, 127.0510699975904 37.68651162385108, 127.0511820480647 37.68631674992967, 127.051438276962 37.68579157275592, 127.0519159083281 37.68481148093378, 127.0520211743524 37.68387038339776, 127.0520064283171 37.68366335462888, 127.0518608964004 37.68246839311038, 127.0518243167355 37.68242206085535, 127.0514922733944 37.68200393262521, 127.0509399137785 37.6801541003366, 127.0491353638527 37.67312020192925, 127.0490814198685 37.67278312247367, 127.0490582101511 37.67263656710896, 127.0489997927894 37.67210005052273, 127.0489729449461 37.67185208122689, 127.0489327699 37.67123003016592, 127.0489329335556 37.67120299259488, 127.0488230556478 37.66909342765484, 127.0436473744994 37.66981596056299, 127.0443345108504 37.67344658299234, 127.0455818318061 37.68078591492918, 127.0455906999645 37.68084453566264, 127.0456084079704 37.68096177701688, 127.0458427373917 37.6825197299999, 127.045876214484 37.68274324490888, 127.0458829218951 37.68278803085727, 127.0460432714284 37.68485495111954, 127.046052453366 37.68497666616771, 127.046000411303 37.68548922227546, 127.0457765068378 37.68768410306507, 127.0453926245258 37.69053533482245, 127.045378152083 37.69064118533486, 127.0450853655148 37.69244158977186, 127.0482048617811 37.69391373716467, 127.049119616799 37.69352177983605, 127.0493707256687 37.69291208863026, 127.0500654214621 37.69045410973693, 127.0500951308458 37.69034831676072, 127.0501270360489 37.69011183923357, 127.0501215535609 37.68984592582086, 127.0500836334237 37.68960784791728, 127.0500331660043 37.68929351461528, 127.0500177129037 37.68919882495007, 127.0500040152239 37.68876838729756, 127.0500268355745 37.688507421964, 127.0500519825985 37.68821988524722, 127.0500614211835 37.68818386802856, 127.0501419085013 37.68788448260014, 127.0502557924347 37.68769833247913, 127.0503509608311 37.68754277415847, 127.0503860079929 37.68748550832971, 127.0504461749347 37.68738878424591, 127.050776586123 37.68702162431446)))"
157,서울특별시,노원구,월계1동,11350560,24044,12375,11669,"MULTIPOLYGON (((127.0680069739077 37.61556823410262, 127.0680085723875 37.61553675426199, 127.0680119786241 37.61543761906754, 127.0677483707991 37.61522145827175, 127.0660519415174 37.61430486632415, 127.0659437238152 37.61428194467599, 127.064866325532 37.61422203862331, 127.0628925772738 37.614343915584, 127.062743322727 37.6143140690092, 127.062421979586 37.61428583761001, 127.062209970092 37.6143323717486, 127.0620142620348 37.61437558597575, 127.0617170282977 37.61451957148898, 127.0615157090982 37.61461709696164, 127.0614617172088 37.61464618995371, 127.0612306731954 37.61477131623737, 127.060911108333 37.61494721882661, 127.0606059962732 37.61565138341141, 127.056909093675 37.61811524061525, 127.0542081923639 37.62017465517391, 127.0539621439419 37.62038045700041, 127.0538447161169 37.62047877302363, 127.0537318603156 37.62057519086872, 127.0533532611913 37.62090150859793, 127.0527221100569 37.62152540572225, 127.052169737963 37.62209468058838, 127.0511054068133 37.6232454792849, 127.0499862497827 37.62443094627259, 127.0590428017117 37.6301999552195, 127.059085444597 37.63005477352098, 127.0591410809946 37.62987020673081, 127.0591580020711 37.62981442743764, 127.05921781494 37.6296422290715, 127.0593126102602 37.62937060382112, 127.0596253999042 37.62857746570442, 127.0599118324496 37.62793069612442, 127.0599434542956 37.62785976321352, 127.0599721392899 37.6277967925969, 127.0601665600132 37.62737281494549, 127.0607376442188 37.62628541193599, 127.0616555875147 37.62432506562808, 127.0620572912199 37.6234038184626, 127.0624063577039 37.62335665740331, 127.0643027948292 37.61903385629999, 127.0650823596917 37.61723489555833, 127.0650792654886 37.61716305620639, 127.0651299733109 37.61696832786424, 127.0651673300569 37.61687720463908, 127.0654560500635 37.61622428226052, 127.0657586340164 37.61554426979004, 127.0658659892754 37.61530324925835, 127.0659595463751 37.61509321108571, 127.0680069739077 37.61556823410262)))"
158,서울특별시,노원구,월계2동,11350570,26209,12620,13589,"MULTIPOLYGON (((127.0549367229935 37.64076175091341, 127.058878455457 37.63763201019638, 127.0595875801588 37.636547419421, 127.058619539014 37.63627117391463, 127.0588167630429 37.63177194901419, 127.0589278001752 37.63072230338163, 127.0589553511313 37.63059286130645, 127.0590428017117 37.6301999552195, 127.0499862497827 37.62443094627259, 127.0482431384028 37.62646750941026, 127.0461649238287 37.62809043681942, 127.0428931432496 37.63043590057197, 127.0421563972672 37.6308757908823, 127.0419667853362 37.6309889022168, 127.0414812112738 37.63127886172986, 127.042903297508 37.6326961199679, 127.0435285847087 37.63307932042195, 127.0439358233289 37.6334369241429, 127.0440253884594 37.63361753809455, 127.0449179507285 37.63592381901407, 127.044922038414 37.63596106457018, 127.0450142656952 37.63686730150587, 127.0452959619486 37.63748693096588, 127.045511426119 37.63782916108731, 127.0463547756851 37.63915622931054, 127.0479963370461 37.641696416249, 127.0505967325711 37.6451472067233, 127.0512475154323 37.64519587752931, 127.0512611927846 37.64515987606064, 127.0522474352914 37.64278859882748, 127.0523328993847 37.64259626220829, 127.0526178710796 37.6420937206894, 127.0528919420551 37.6417545046208, 127.0532050551061 37.64140078901043, 127.0533753688898 37.64123468635299, 127.0536181302607 37.64103505740079, 127.0540095249625 37.64074022273304, 127.05413035752 37.64067307909147, 127.0541928021617 37.64065760474485, 127.0542736702483 37.64063756709279, 127.0543713961145 37.64064356962696, 127.0549367229935 37.64076175091341)))"
159,서울특별시,노원구,월계3동,11350580,31904,15299,16605,"MULTIPOLYGON (((127.0643921726835 37.63078316429583, 127.0646905926653 37.629288041129, 127.0648440995457 37.62887372046137, 127.0649402994601 37.62861408360546, 127.0653507541347 37.62818971300955, 127.0671577675256 37.62645676840337, 127.0682580298699 37.62554819185238, 127.0700458788758 37.62355261615754, 127.0708313939844 37.62157027133259, 127.0711673369631 37.61807654063481, 127.0711766221859 37.61732181749483, 127.0711866848789 37.61643403641954, 127.0711870608496 37.61636856878375, 127.0680069739077 37.61556823410262, 127.0659595463751 37.61509321108571, 127.0658659892754 37.61530324925835, 127.0657586340164 37.61554426979004, 127.0654560500635 37.61622428226052, 127.0651673300569 37.61687720463908, 127.0651299733109 37.61696832786424, 127.0650792654886 37.61716305620639, 127.0650823596917 37.61723489555833, 127.0643027948292 37.61903385629999, 127.0624063577039 37.62335665740331, 127.0620572912199 37.6234038184626, 127.0616555875147 37.62432506562808, 127.0607376442188 37.62628541193599, 127.0601665600132 37.62737281494549, 127.0599721392899 37.6277967925969, 127.0599434542956 37.62785976321352, 127.0599118324496 37.62793069612442, 127.0596253999042 37.62857746570442, 127.0593126102602 37.62937060382112, 127.05921781494 37.6296422290715, 127.0591580020711 37.62981442743764, 127.0591410809946 37.62987020673081, 127.059085444597 37.63005477352098, 127.0590428017117 37.6301999552195, 127.0589553511313 37.63059286130645, 127.0589278001752 37.63072230338163, 127.0588167630429 37.63177194901419, 127.058619539014 37.63627117391463, 127.0595875801588 37.636547419421, 127.0602788102759 37.63548979761414, 127.0604994757752 37.63518867120438, 127.0608755757636 37.63471348849469, 127.0611804707844 37.63442168761304, 127.0616026226658 37.63406610124106, 127.062224677423 37.63354366917038, 127.0622824337252 37.63349513991735, 127.0628910877979 37.63298364097061, 127.0635870875621 37.63235154450302, 127.0637022443328 37.63223853228068, 127.0638627157962 37.63205209757233, 127.0639531517047 37.63190934414314, 127.0640151426105 37.63178563900556, 127.0641474210322 37.63145263198656, 127.0643921726835 37.63078316429583)))"
160,서울특별시,노원구,공릉2동,11350600,41184,20112,21072,"MULTIPOLYGON (((127.1111547150308 37.64241159163723, 127.1113431681463 37.64200322978058, 127.111952928205 37.64027121247874, 127.1123843166474 37.63522852209713, 127.112037346379 37.63261805396303, 127.1114171702813 37.63133047528535, 127.1109832437388 37.630593313859, 127.1109105060214 37.63053030911303, 127.1108422361546 37.63047117950295, 127.1104168445163 37.63013965942013, 127.1086172819864 37.62914110161589, 127.1054887054485 37.6272603987759, 127.1053697111727 37.6271395094988, 127.10526388508 37.62691375698886, 127.1035298845655 37.62306597308524, 127.1035258790108 37.62303710766002, 127.1035073800031 37.62290365585501, 127.1036576991078 37.62247038985247, 127.1039815265633 37.62177293671335, 127.1040343835983 37.62168861323609, 127.1040650043558 37.62165829567524, 127.1042385463018 37.62152029643653, 127.1042859230673 37.62149492930435, 127.104351470902 37.62145983450124, 127.1049634988318 37.62117120203771, 127.1050166211579 37.62117137986713, 127.1051072795522 37.62117055661676, 127.1052467586754 37.62116263631543, 127.1052967429842 37.62115471667482, 127.1053651304102 37.62113150779491, 127.105423089023 37.62111240386971, 127.1055044495401 37.6210648506605, 127.1056208358796 37.62102017257141, 127.1056584611314 37.62100227146323, 127.1056962927355 37.62095387861017, 127.1057192070113 37.62089994672438, 127.1057103671428 37.62083343234811, 127.1050234514556 37.62068355101992, 127.1018250808344 37.61988750714062, 127.1015509175861 37.61981460047555, 127.101507534023 37.61980306100443, 127.1014468806646 37.61975553566823, 127.10049900621 37.61888140793475, 127.0970417957927 37.61704990099349, 127.0969508346434 37.6170514687451, 127.096815539729 37.61705380072442, 127.0961481577492 37.61710221913889, 127.0930468069291 37.61804135536808, 127.0926075054631 37.61821109376334, 127.0924357476132 37.61827922804378, 127.0895430036712 37.6196436667868, 127.0879730824871 37.61988710210396, 127.0857277524712 37.62016784234584, 127.0841503734334 37.61963268875622, 127.0824457661857 37.61929549265066, 127.0816372327308 37.61925094176976, 127.0810323469284 37.61976611198904, 127.0807992586668 37.61978201307974, 127.0803213193 37.61988847527781, 127.0801609095515 37.61995099770535, 127.0800073845013 37.62001232850748, 127.0798897590067 37.62005932038478, 127.0796979814874 37.62015225084151, 127.0796404980882 37.6201801138707, 127.0795424922049 37.62022821183289, 127.0793051942698 37.62036144068242, 127.079062046252 37.62052619514987, 127.0786171806544 37.62092007112715, 127.0785559400178 37.6209761989048, 127.0785111268233 37.62101768624576, 127.0783142657128 37.62126037224358, 127.078147226518 37.62161693187775, 127.0780576441305 37.62184988513667, 127.0779070874375 37.62237770686568, 127.0778482882546 37.62275605999918, 127.0777959689489 37.62309659794587, 127.0777776914651 37.6232166182777, 127.0777563427458 37.62335269853286, 127.0777269882151 37.62353979309832, 127.0776476550763 37.62404200700863, 127.0776329674113 37.62413434192661, 127.0775411775114 37.62471087177823, 127.0775367749603 37.62473789625414, 127.0775194282365 37.62480984680683, 127.0774468660148 37.62510599755123, 127.0773934471802 37.6252838211287, 127.0773501351117 37.6254278805845, 127.0773206697198 37.6255021356836, 127.0772402150801 37.6257012691796, 127.0771906550102 37.62582389932829, 127.0771139970342 37.62597685260025, 127.0768714822372 37.62645861525955, 127.0768331889781 37.62653467730014, 127.0763966510771 37.62719340533248, 127.0762365966946 37.62740915422405, 127.0762059910583 37.62745037077898, 127.0761497369812 37.62752595345414, 127.0761048153487 37.62757761917573, 127.075973653289 37.62772474244992, 127.075807604813 37.62790441376102, 127.0757590581422 37.62795614112542, 127.0757271020049 37.62798524498537, 127.0756830521532 37.62802499795134, 127.0756288527236 37.6280738990588, 127.0754872368286 37.62819169060426, 127.0740058139887 37.62937274093585, 127.0731318314119 37.62997798703553, 127.072101449678 37.63068180689676, 127.0717324801668 37.63091594334212, 127.0713030206085 37.63108455495713, 127.0741689358086 37.63082561441353, 127.0753095092523 37.6307608268557, 127.0766474283549 37.63468550960369, 127.0803325342346 37.63641234612692, 127.0804038643146 37.63644978008472, 127.0807471168154 37.63663126734353, 127.0814864530141 37.63742707103784, 127.0815399608874 37.63748584789682, 127.0815843098576 37.63753670552991, 127.0830571475684 37.64007243694621, 127.0857062291669 37.64088846044095, 127.0859722851913 37.64094235260033, 127.0860261230646 37.64094479036486, 127.0877990753969 37.64098705170545, 127.087933679276 37.64098639524257, 127.0880144565354 37.64098329732594, 127.0883199055833 37.64096070341867, 127.0884106845673 37.64093624233981, 127.0884789246891 37.64090041780921, 127.0885087461805 37.64088812841261, 127.0886599098357 37.6408402085722, 127.0887209322494 37.64082239453186, 127.0891743563219 37.6408160875999, 127.0892572342984 37.64081637616867, 127.0905584860561 37.64109693442653, 127.0910309189742 37.64125520776972, 127.0941335707078 37.64258973707528, 127.0946184943385 37.64382961872195, 127.0944521249958 37.64575907901987, 127.0949337397759 37.64551287093798, 127.0978142702977 37.64528157298292, 127.101390762028 37.64538159103911, 127.1039551675922 37.64563030387349, 127.1065679557293 37.64548959251487, 127.1074231843214 37.6450272604614, 127.108028009221 37.6446388249795, 127.1080655150077 37.6445189759404, 127.1082161633802 37.64415835478689, 127.1090686889435 37.64302662200146, 127.1091819016218 37.64291883546271, 127.1095597169287 37.64260574520515, 127.1095903087356 37.64258218628236, 127.1096439830616 37.64254932529064, 127.1097032964396 37.64251495966596, 127.1097487594242 37.64249144899672, 127.1111547150308 37.64241159163723)))"
161,서울특별시,노원구,하계1동,11350611,29814,14425,15389,"MULTIPOLYGON (((127.0764968029361 37.64599677094907, 127.0782135200546 37.64435121895978, 127.0783283487344 37.64429263684939, 127.0791236639112 37.64388690013774, 127.0795889665329 37.64416572074305, 127.0799402947678 37.64417711225605, 127.0806916084691 37.64386206318006, 127.0809093411108 37.64368037439045, 127.0819414812234 37.6421877556779, 127.083092866669 37.64050745206512, 127.0830571475684 37.64007243694621, 127.0815843098576 37.63753670552991, 127.0815399608874 37.63748584789682, 127.0814864530141 37.63742707103784, 127.0807471168154 37.63663126734353, 127.0804038643146 37.63644978008472, 127.0803325342346 37.63641234612692, 127.0766474283549 37.63468550960369, 127.0753095092523 37.6307608268557, 127.0741689358086 37.63082561441353, 127.0713030206085 37.63108455495713, 127.0702974405061 37.63140308284097, 127.0694011232014 37.63329376095565, 127.0687511004398 37.63421371239869, 127.0667974362328 37.63868328621611, 127.0693580060838 37.63939107808169, 127.0718545395042 37.64309798522245, 127.0712086952914 37.64440934004335, 127.0707664266079 37.64530568973453, 127.0728876382146 37.6459105248429, 127.0742059423267 37.64628600877988, 127.0742424515757 37.64624118361381, 127.0746496718267 37.64540200165457, 127.076044299343 37.64446331163459, 127.0764968029361 37.64599677094907)))"
162,서울특별시,노원구,하계2동,11350612,23492,11224,12268,"MULTIPOLYGON (((127.0667974362328 37.63868328621611, 127.0687511004398 37.63421371239869, 127.0694011232014 37.63329376095565, 127.0702974405061 37.63140308284097, 127.0643921726835 37.63078316429583, 127.0641474210322 37.63145263198656, 127.0640151426105 37.63178563900556, 127.0639531517047 37.63190934414314, 127.0638627157962 37.63205209757233, 127.0637022443328 37.63223853228068, 127.0635870875621 37.63235154450302, 127.0628910877979 37.63298364097061, 127.0622824337252 37.63349513991735, 127.062224677423 37.63354366917038, 127.0616026226658 37.63406610124106, 127.0611804707844 37.63442168761304, 127.0608755757636 37.63471348849469, 127.0604994757752 37.63518867120438, 127.0602788102759 37.63548979761414, 127.0595875801588 37.636547419421, 127.058878455457 37.63763201019638, 127.0601282037351 37.63953064201265, 127.0613556036335 37.63717807589246, 127.0667974362328 37.63868328621611)))"
163,서울특별시,노원구,중계본동,11350619,26161,12822,13339,"MULTIPOLYGON (((127.0944521249958 37.64575907901987, 127.0946184943385 37.64382961872195, 127.0941335707078 37.64258973707528, 127.0910309189742 37.64125520776972, 127.0905584860561 37.64109693442653, 127.0892572342984 37.64081637616867, 127.0891743563219 37.6408160875999, 127.0887209322494 37.64082239453186, 127.0886599098357 37.6408402085722, 127.0885087461805 37.64088812841261, 127.0884789246891 37.64090041780921, 127.0884106845673 37.64093624233981, 127.0883199055833 37.64096070341867, 127.0880144565354 37.64098329732594, 127.087933679276 37.64098639524257, 127.0877990753969 37.64098705170545, 127.0860261230646 37.64094479036486, 127.0859722851913 37.64094235260033, 127.0857062291669 37.64088846044095, 127.0830571475684 37.64007243694621, 127.083092866669 37.64050745206512, 127.0819414812234 37.6421877556779, 127.0809093411108 37.64368037439045, 127.0806916084691 37.64386206318006, 127.0799402947678 37.64417711225605, 127.0795889665329 37.64416572074305, 127.0791236639112 37.64388690013774, 127.0783283487344 37.64429263684939, 127.0782135200546 37.64435121895978, 127.0764968029361 37.64599677094907, 127.0767146846649 37.65017299888395, 127.0780583606619 37.6527432435702, 127.0781056219676 37.6528425596778, 127.0781324566742 37.65292152263497, 127.0781634549398 37.65307711411751, 127.0781708417386 37.65314607568508, 127.0781727624276 37.65318530783662, 127.0781735514634 37.65322418532117, 127.0781744284216 37.65326756079126, 127.0781746724048 37.65334868198867, 127.0781735412641 37.65343320802533, 127.0860344339984 37.65591267225598, 127.0863414045695 37.65550250517057, 127.0865764337743 37.65541206875153, 127.0892112815248 37.65495032506607, 127.0906216059245 37.65489551337495, 127.0928180847938 37.65490311643604, 127.0936018870392 37.65331721238588, 127.0922979171514 37.64999466384976, 127.092292483244 37.64995183152142, 127.0922961801849 37.64992255081743, 127.0923365712945 37.64973166085122, 127.0923652786209 37.64959605461469, 127.0924472102339 37.64925270260073, 127.092554152108 37.64888000279649, 127.092579281773 37.64881150316963, 127.093481217307 37.64698715140819, 127.0939403476514 37.64633075468102, 127.0944521249958 37.64575907901987)))"
164,서울특별시,노원구,중계1동,11350621,28152,13779,14373,"MULTIPOLYGON (((127.0781735412641 37.65343320802533, 127.0781746724048 37.65334868198867, 127.0781744284216 37.65326756079126, 127.0781735514634 37.65322418532117, 127.0781727624276 37.65318530783662, 127.0781708417386 37.65314607568508, 127.0781634549398 37.65307711411751, 127.0781324566742 37.65292152263497, 127.0781056219676 37.6528425596778, 127.0780583606619 37.6527432435702, 127.0767146846649 37.65017299888395, 127.0764968029361 37.64599677094907, 127.076044299343 37.64446331163459, 127.0746496718267 37.64540200165457, 127.0742424515757 37.64624118361381, 127.0742059423267 37.64628600877988, 127.0728876382146 37.6459105248429, 127.0707664266079 37.64530568973453, 127.0685997234079 37.650483957125, 127.0687727153406 37.65062385430719, 127.069675073114 37.65135358197772, 127.069738652596 37.65140963368746, 127.0701925274333 37.651820378038, 127.0703786529312 37.65198882187427, 127.0706020673647 37.65219128240557, 127.0707082157155 37.65230756263446, 127.0708452373506 37.65245767409767, 127.0710015911574 37.65262896501349, 127.0710616138668 37.65269472849292, 127.0713984197509 37.65306399553842, 127.0714450718774 37.65315437532043, 127.0716822123335 37.65361596838073, 127.0719140436382 37.65406841924097, 127.0720098658462 37.6545500410249, 127.0720793985774 37.65490294120293, 127.0721296406853 37.65516225769289, 127.0742161785771 37.65469322571132, 127.0781735412641 37.65343320802533)))"
165,서울특별시,노원구,중계4동,11350624,21480,10427,11053,"MULTIPOLYGON (((127.0939603161348 37.66257066784948, 127.0924449558524 37.65809256043152, 127.0902294304264 37.65727818865801, 127.0884451662493 37.65662297855811, 127.0860344339984 37.65591267225598, 127.0781735412641 37.65343320802533, 127.0742161785771 37.65469322571132, 127.0721296406853 37.65516225769289, 127.0716081987566 37.65835898210951, 127.074410532109 37.66149342815591, 127.0748120660006 37.6618578332329, 127.0749963064734 37.66202502796082, 127.0752650647878 37.66226718437964, 127.0758597403587 37.66259034383584, 127.0775309890142 37.66241044187189, 127.0776672977135 37.66236586231715, 127.0782440138665 37.66200964490564, 127.078470893823 37.66186173552491, 127.0785291025768 37.66184391771417, 127.0787894212472 37.6617997898056, 127.0796008607468 37.66191308919721, 127.0832132846499 37.66244305005215, 127.0858305570274 37.66302349046191, 127.0888036659605 37.66372116080974, 127.0906170633373 37.66333538924495, 127.0907493206301 37.66312516095038, 127.0939603161348 37.66257066784948)))"
166,서울특별시,노원구,상계1동,11350630,40359,19621,20738,"MULTIPOLYGON (((127.0817643013185 37.69637761093475, 127.0828618241087 37.69509936382106, 127.0834884177432 37.69461147918786, 127.0837667603478 37.69465978186424, 127.0842893167472 37.69401039201506, 127.0851353454603 37.69141643366331, 127.0851397887915 37.69099958353509, 127.0850165685174 37.69085043029949, 127.0849258794461 37.69084335023972, 127.0836389686938 37.69012676170825, 127.0801147781178 37.68855270936734, 127.0791766086466 37.688478385392, 127.0785302054 37.68783725813901, 127.0769532633321 37.68616414791165, 127.0759662825315 37.68434103922526, 127.0752049102357 37.68224382829577, 127.0738425523725 37.67765889722531, 127.0738042964269 37.67728707804542, 127.0736249934512 37.67678844337711, 127.0713217816202 37.67477124683261, 127.071213578841 37.67470973408184, 127.0711522380054 37.67467486379887, 127.0709826883435 37.67457960716579, 127.0705346870026 37.6743470099972, 127.0690534182672 37.67387519840654, 127.0687705222847 37.67399919288779, 127.0677053395211 37.67423640020401, 127.0669273814581 37.67395187949692, 127.0666783070872 37.67384792422231, 127.06655971252 37.67379842345931, 127.0653931521181 37.67331304925948, 127.0633567471401 37.67262502100967, 127.0627088408633 37.67240630055917, 127.0598123758279 37.67226708605564, 127.0582611091466 37.6712979860916, 127.0562373367592 37.67051975884873, 127.0489329335556 37.67120299259488, 127.0489327699 37.67123003016592, 127.0489729449461 37.67185208122689, 127.0489997927894 37.67210005052273, 127.0490582101511 37.67263656710896, 127.0490814198685 37.67278312247367, 127.0491353638527 37.67312020192925, 127.0509399137785 37.6801541003366, 127.0514922733944 37.68200393262521, 127.0518243167355 37.68242206085535, 127.0518608964004 37.68246839311038, 127.0520064283171 37.68366335462888, 127.0520211743524 37.68387038339776, 127.0519159083281 37.68481148093378, 127.051438276962 37.68579157275592, 127.0511820480647 37.68631674992967, 127.0510699975904 37.68651162385108, 127.0509441011908 37.68673047442097, 127.050776586123 37.68702162431446, 127.0529362031074 37.68813058062359, 127.0546291688915 37.68928505664032, 127.054822324242 37.68934775245587, 127.0568264331742 37.68956824131381, 127.0575526279712 37.68939971530102, 127.0581620504097 37.689154918382, 127.0588490261479 37.68894489335736, 127.0603802734689 37.68869260562671, 127.0617963490386 37.68897728871095, 127.0645116603757 37.68964416068787, 127.0651116555349 37.68984695256607, 127.0653479559941 37.69004949656394, 127.0654737670722 37.69023360639277, 127.0656354151459 37.690473054608, 127.0656609083405 37.69060407583228, 127.0682601064685 37.69346609793195, 127.0683667840636 37.69358051397556, 127.0688124734554 37.69405849045226, 127.0693927185226 37.69436593641173, 127.0699444646064 37.69426079973694, 127.0704301384257 37.69407678773025, 127.0710380992895 37.6941285740431, 127.0719958366409 37.69425598704551, 127.0726276639563 37.69434953832687, 127.0728313983398 37.69442576295832, 127.0729155726646 37.69445761441659, 127.0744641422808 37.69547696624939, 127.0759447812835 37.69596137523485, 127.0773411225875 37.69638438035926, 127.0817643013185 37.69637761093475)))"
167,서울특별시,노원구,상계2동,11350640,21358,10516,10842,"MULTIPOLYGON (((127.0716081987566 37.65835898210951, 127.0721296406853 37.65516225769289, 127.0720793985774 37.65490294120293, 127.0720098658462 37.6545500410249, 127.0719140436382 37.65406841924097, 127.0716822123335 37.65361596838073, 127.0714450718774 37.65315437532043, 127.0713984197509 37.65306399553842, 127.0710616138668 37.65269472849292, 127.0710015911574 37.65262896501349, 127.0708452373506 37.65245767409767, 127.0707082157155 37.65230756263446, 127.0706020673647 37.65219128240557, 127.0703786529312 37.65198882187427, 127.0701925274333 37.651820378038, 127.069738652596 37.65140963368746, 127.069675073114 37.65135358197772, 127.0687727153406 37.65062385430719, 127.0685997234079 37.650483957125, 127.0674041412359 37.65457492767736, 127.0673477510483 37.6547685081986, 127.0670960649258 37.65562519281846, 127.067014793022 37.65575296450153, 127.0664046614795 37.65562244163894, 127.0649907290426 37.65531866835096, 127.0644530126091 37.65518712703199, 127.0623577609605 37.65470841508404, 127.0607770493773 37.65436272461225, 127.0604315984749 37.65570637470495, 127.0608167875992 37.65576964558136, 127.0610645269063 37.65581338023463, 127.0613468451825 37.6558820306005, 127.0617161039586 37.65597348176664, 127.0615838009594 37.65739715497208, 127.0626008364415 37.6589286946, 127.0628911613917 37.65896244420089, 127.0646604609714 37.65921572788024, 127.0652120887882 37.65940028289867, 127.0652960555401 37.6597345732591, 127.0653256620586 37.65985249593463, 127.0655047085034 37.6606204174333, 127.0656850867331 37.66139623015767, 127.0657217724522 37.66155409891041, 127.0680546314583 37.6603154417295, 127.0716081987566 37.65835898210951)))"
168,서울특별시,노원구,상계5동,11350670,25704,12519,13185,"MULTIPOLYGON (((127.0701179182524 37.6679528930581, 127.0709420834061 37.66735301381087, 127.0709588073298 37.66684889058794, 127.0709485831332 37.66662968034947, 127.0709414405942 37.66647984352589, 127.0708476533375 37.66615389515249, 127.0707683996769 37.66588658634055, 127.070726162383 37.66559444521234, 127.0707397749937 37.66544370143087, 127.0707508011881 37.66537388810459, 127.0708054232539 37.66524113997414, 127.0708983504016 37.66510177115986, 127.0710161245384 37.66494440915395, 127.0710689336076 37.66486787326254, 127.0712185091074 37.6646353679176, 127.0712972089346 37.66453180666546, 127.0713312439794 37.66450170409117, 127.0714012286451 37.6644417627498, 127.0720532394022 37.66402887151514, 127.0724886543482 37.66377525541188, 127.0736300650422 37.66277158579157, 127.074410532109 37.66149342815591, 127.0716081987566 37.65835898210951, 127.0680546314583 37.6603154417295, 127.0657217724522 37.66155409891041, 127.0667003205549 37.66778028815757, 127.0667204345562 37.66784093622429, 127.0685695037036 37.66805636856618, 127.0691300369966 37.66799030368649, 127.0693594793317 37.66783713961203, 127.0701179182524 37.6679528930581)))"
169,서울특별시,노원구,상계8동,11350700,24086,11615,12471,"MULTIPOLYGON (((127.0562373367592 37.67051975884873, 127.0576801468166 37.66419094433218, 127.0580252853218 37.66373941653609, 127.0586948385734 37.6612105143196, 127.0587015645047 37.66118440977675, 127.0527788858694 37.66167135744219, 127.0514706872939 37.66180497048797, 127.0513249316754 37.66365215226944, 127.0512662954931 37.66397528297286, 127.0511265089684 37.66435894491136, 127.0510479668308 37.66457383958274, 127.0508472559588 37.66495388923534, 127.0506083921243 37.66531463980874, 127.0500622060655 37.66610573169422, 127.0497914920737 37.66645959901744, 127.0497579145605 37.66650341088594, 127.0497166684124 37.66655721630399, 127.0496657763181 37.66662361256924, 127.049287775318 37.66737252929413, 127.0492769876309 37.66739952808896, 127.0490133991119 37.66806920937042, 127.0488868741077 37.66874327739212, 127.0488230556478 37.66909342765484, 127.0489329335556 37.67120299259488, 127.0562373367592 37.67051975884873)))"
170,서울특별시,노원구,상계9동,11350710,22002,10501,11501,"MULTIPOLYGON (((127.0701179182524 37.6679528930581, 127.0693594793317 37.66783713961203, 127.0691300369966 37.66799030368649, 127.0685695037036 37.66805636856618, 127.0667204345562 37.66784093622429, 127.0667003205549 37.66778028815757, 127.0657217724522 37.66155409891041, 127.0656850867331 37.66139623015767, 127.0642332065081 37.66139200207918, 127.0635371838766 37.66139062748413, 127.0629272485838 37.66138942358543, 127.0629499246332 37.66156921582656, 127.0629987135498 37.66188992941345, 127.063052924479 37.6619520609807, 127.0631353234572 37.6624008164698, 127.0632046692478 37.66277963401435, 127.0634274434418 37.66479558941792, 127.063330303229 37.66482982486819, 127.0631561624348 37.66489083135364, 127.0626278615158 37.66507252052625, 127.0625090159169 37.66510474415144, 127.062426987994 37.66512698225788, 127.0622177409939 37.6651611325384, 127.0618745691137 37.66519253173246, 127.0616195793212 37.66517130428696, 127.0611070111012 37.66508715138431, 127.0580390843666 37.66458265781987, 127.0580252853218 37.66373941653609, 127.0576801468166 37.66419094433218, 127.0562373367592 37.67051975884873, 127.0582611091466 37.6712979860916, 127.0598123758279 37.67226708605564, 127.0627088408633 37.67240630055917, 127.0633567471401 37.67262502100967, 127.0653931521181 37.67331304925948, 127.06655971252 37.67379842345931, 127.0662757189382 37.67047822343611, 127.0701179182524 37.6679528930581)))"
171,서울특별시,노원구,상계10동,11350720,16736,7717,9019,"MULTIPOLYGON (((127.0656850867331 37.66139623015767, 127.0655047085034 37.6606204174333, 127.0653256620586 37.65985249593463, 127.0652960555401 37.6597345732591, 127.0652120887882 37.65940028289867, 127.0646604609714 37.65921572788024, 127.0628911613917 37.65896244420089, 127.0626008364415 37.6589286946, 127.0615838009594 37.65739715497208, 127.0617161039586 37.65597348176664, 127.0613468451825 37.6558820306005, 127.0610645269063 37.65581338023463, 127.0608167875992 37.65576964558136, 127.0604315984749 37.65570637470495, 127.0541817443508 37.65448156002282, 127.0524350243087 37.65816160704357, 127.0515512451182 37.66065721043847, 127.0514706872939 37.66180497048797, 127.0527788858694 37.66167135744219, 127.0587015645047 37.66118440977675, 127.0586948385734 37.6612105143196, 127.0580252853218 37.66373941653609, 127.0580390843666 37.66458265781987, 127.0611070111012 37.66508715138431, 127.0616195793212 37.66517130428696, 127.0618745691137 37.66519253173246, 127.0622177409939 37.6651611325384, 127.062426987994 37.66512698225788, 127.0625090159169 37.66510474415144, 127.0626278615158 37.66507252052625, 127.0631561624348 37.66489083135364, 127.063330303229 37.66482982486819, 127.0634274434418 37.66479558941792, 127.0632046692478 37.66277963401435, 127.0631353234572 37.6624008164698, 127.063052924479 37.6619520609807, 127.0629987135498 37.66188992941345, 127.0629499246332 37.66156921582656, 127.0629272485838 37.66138942358543, 127.0635371838766 37.66139062748413, 127.0642332065081 37.66139200207918, 127.0656850867331 37.66139623015767)))"
172,서울특별시,노원구,상계3.4동,11350665,25946,12910,13036,"MULTIPOLYGON (((127.0959236405964 37.68771674545949, 127.09632169639 37.68594699061475, 127.0962941577226 37.68578945158403, 127.0962852250721 37.68573840107765, 127.0958553659116 37.68475225444332, 127.0956329917805 37.6843222324789, 127.0955262846959 37.68426327992592, 127.095398373239 37.68419298787121, 127.0950627924164 37.68410054460098, 127.0949857258267 37.68408115818347, 127.0946735714861 37.68400121912899, 127.0942811964786 37.68355145685897, 127.0928114290922 37.68180456552624, 127.09279669609 37.68177986770572, 127.0926985144671 37.68158334902238, 127.0918277644445 37.67918729889652, 127.0918385261507 37.67901351399286, 127.0918440904439 37.67892377035457, 127.0919278245293 37.6783877117055, 127.0920409643901 37.67791828300013, 127.0922702168181 37.6774818929083, 127.092464327705 37.67735979314899, 127.0927891254997 37.67738356103537, 127.0929814228477 37.67728496544887, 127.0936108887175 37.67662240242925, 127.0955615428818 37.67280745073942, 127.0956342594829 37.67259926646408, 127.0957388320299 37.67226500448962, 127.0957478426346 37.67200242252866, 127.0957283078866 37.67041723136968, 127.0944090433704 37.66436474336257, 127.0939603161348 37.66257066784948, 127.0907493206301 37.66312516095038, 127.0906170633373 37.66333538924495, 127.0888036659605 37.66372116080974, 127.0858305570274 37.66302349046191, 127.0832132846499 37.66244305005215, 127.0796008607468 37.66191308919721, 127.0787894212472 37.6617997898056, 127.0785291025768 37.66184391771417, 127.078470893823 37.66186173552491, 127.0782440138665 37.66200964490564, 127.0776672977135 37.66236586231715, 127.0775309890142 37.66241044187189, 127.0758597403587 37.66259034383584, 127.0752650647878 37.66226718437964, 127.0749963064734 37.66202502796082, 127.0748120660006 37.6618578332329, 127.074410532109 37.66149342815591, 127.0736300650422 37.66277158579157, 127.0724886543482 37.66377525541188, 127.0720532394022 37.66402887151514, 127.0714012286451 37.6644417627498, 127.0713312439794 37.66450170409117, 127.0712972089346 37.66453180666546, 127.0712185091074 37.6646353679176, 127.0710689336076 37.66486787326254, 127.0710161245384 37.66494440915395, 127.0708983504016 37.66510177115986, 127.0708054232539 37.66524113997414, 127.0707508011881 37.66537388810459, 127.0707397749937 37.66544370143087, 127.070726162383 37.66559444521234, 127.0707683996769 37.66588658634055, 127.0708476533375 37.66615389515249, 127.0709414405942 37.66647984352589, 127.0709485831332 37.66662968034947, 127.0709588073298 37.66684889058794, 127.0709420834061 37.66735301381087, 127.0701179182524 37.6679528930581, 127.0662757189382 37.67047822343611, 127.06655971252 37.67379842345931, 127.0666783070872 37.67384792422231, 127.0669273814581 37.67395187949692, 127.0677053395211 37.67423640020401, 127.0687705222847 37.67399919288779, 127.0690534182672 37.67387519840654, 127.0705346870026 37.6743470099972, 127.0709826883435 37.67457960716579, 127.0711522380054 37.67467486379887, 127.071213578841 37.67470973408184, 127.0713217816202 37.67477124683261, 127.0736249934512 37.67678844337711, 127.0738042964269 37.67728707804542, 127.0738425523725 37.67765889722531, 127.0752049102357 37.68224382829577, 127.0759662825315 37.68434103922526, 127.0769532633321 37.68616414791165, 127.0785302054 37.68783725813901, 127.0791766086466 37.688478385392, 127.0801147781178 37.68855270936734, 127.0836389686938 37.69012676170825, 127.0849258794461 37.69084335023972, 127.0858325964107 37.69045220569688, 127.0862360158047 37.69031391546932, 127.0889917161366 37.68975571318239, 127.0894077678408 37.68976842915546, 127.0895920989566 37.68981201025142, 127.089925284265 37.68989078300638, 127.092200271205 37.68973079900294, 127.092326550945 37.68972096945145, 127.0924080690191 37.68971461742983, 127.0928350134774 37.68967891237453, 127.0949516952697 37.68916680911251, 127.0953075056197 37.68904409754015, 127.0955029777055 37.68897048941079, 127.0955802731328 37.68894138010214, 127.0957919552672 37.68886098597054, 127.0959236405964 37.68771674545949)))"
173,서울특별시,노원구,상계6.7동,11350695,34834,16201,18633,"MULTIPOLYGON (((127.0685997234079 37.650483957125, 127.0674135932304 37.6500141991586, 127.0661738203499 37.64950715099871, 127.0659219892246 37.64937778408669, 127.0658353467827 37.64932054580405, 127.0657677724931 37.6492758161, 127.0614912521265 37.64530199952103, 127.0614539440472 37.64526206678304, 127.0614004264917 37.64520476808776, 127.0613817542645 37.64518019129586, 127.0613266151178 37.64510759985055, 127.0612528257349 37.64500479828725, 127.0611918064992 37.64490091750405, 127.0611382291262 37.64474982526141, 127.0611026040411 37.64464933778762, 127.0610711579212 37.64433375257597, 127.061056619779 37.64415568426872, 127.0610342368532 37.64386604620611, 127.0610181978354 37.64334208387076, 127.0608930401389 37.64173723635084, 127.0608407858544 37.64146776706328, 127.060306689226 37.64001574972101, 127.0601282037351 37.63953064201265, 127.058878455457 37.63763201019638, 127.0549367229935 37.64076175091341, 127.0550725023237 37.64163205430179, 127.0557321273785 37.64530636478925, 127.0558925360127 37.64597057843638, 127.0555782805938 37.64710846000215, 127.0554720134934 37.64746521447897, 127.0553245440921 37.64795814076875, 127.055211778361 37.64833402386896, 127.0550447150647 37.6486657618732, 127.0548246354336 37.64909757329347, 127.0546334731828 37.64947215039233, 127.0545335796458 37.64966769680229, 127.0544303290065 37.65011008854238, 127.0544082551991 37.65020534856294, 127.0543612325222 37.65040839531875, 127.0542922305815 37.65092978320251, 127.0542379646926 37.65194808840428, 127.0542347089319 37.65203948964069, 127.0542311517202 37.65213959664602, 127.0542181207426 37.65254064208442, 127.0542088704457 37.65302169627572, 127.0541817443508 37.65448156002282, 127.0604315984749 37.65570637470495, 127.0607770493773 37.65436272461225, 127.0623577609605 37.65470841508404, 127.0644530126091 37.65518712703199, 127.0649907290426 37.65531866835096, 127.0664046614795 37.65562244163894, 127.067014793022 37.65575296450153, 127.0670960649258 37.65562519281846, 127.0673477510483 37.6547685081986, 127.0674041412359 37.65457492767736, 127.0685997234079 37.650483957125)))"
174,서울특별시,노원구,중계2.3동,11350625,37108,17261,19847,"MULTIPOLYGON (((127.0707664266079 37.64530568973453, 127.0712086952914 37.64440934004335, 127.0718545395042 37.64309798522245, 127.0693580060838 37.63939107808169, 127.0667974362328 37.63868328621611, 127.0613556036335 37.63717807589246, 127.0601282037351 37.63953064201265, 127.060306689226 37.64001574972101, 127.0608407858544 37.64146776706328, 127.0608930401389 37.64173723635084, 127.0610181978354 37.64334208387076, 127.0610342368532 37.64386604620611, 127.061056619779 37.64415568426872, 127.0610711579212 37.64433375257597, 127.0611026040411 37.64464933778762, 127.0611382291262 37.64474982526141, 127.0611918064992 37.64490091750405, 127.0612528257349 37.64500479828725, 127.0613266151178 37.64510759985055, 127.0613817542645 37.64518019129586, 127.0614004264917 37.64520476808776, 127.0614539440472 37.64526206678304, 127.0614912521265 37.64530199952103, 127.0657677724931 37.6492758161, 127.0658353467827 37.64932054580405, 127.0659219892246 37.64937778408669, 127.0661738203499 37.64950715099871, 127.0674135932304 37.6500141991586, 127.0685997234079 37.650483957125, 127.0707664266079 37.64530568973453)))"
175,서울특별시,노원구,공릉1동,11350595,39256,19197,20059,"MULTIPOLYGON (((127.0713030206085 37.63108455495713, 127.0717324801668 37.63091594334212, 127.072101449678 37.63068180689676, 127.0731318314119 37.62997798703553, 127.0740058139887 37.62937274093585, 127.0754872368286 37.62819169060426, 127.0756288527236 37.6280738990588, 127.0756830521532 37.62802499795134, 127.0757271020049 37.62798524498537, 127.0757590581422 37.62795614112542, 127.075807604813 37.62790441376102, 127.075973653289 37.62772474244992, 127.0761048153487 37.62757761917573, 127.0761497369812 37.62752595345414, 127.0762059910583 37.62745037077898, 127.0762365966946 37.62740915422405, 127.0763966510771 37.62719340533248, 127.0768331889781 37.62653467730014, 127.0768714822372 37.62645861525955, 127.0771139970342 37.62597685260025, 127.0771906550102 37.62582389932829, 127.0772402150801 37.6257012691796, 127.0773206697198 37.6255021356836, 127.0773501351117 37.6254278805845, 127.0773934471802 37.6252838211287, 127.0774468660148 37.62510599755123, 127.0775194282365 37.62480984680683, 127.0775367749603 37.62473789625414, 127.0775411775114 37.62471087177823, 127.0776329674113 37.62413434192661, 127.0776476550763 37.62404200700863, 127.0777269882151 37.62353979309832, 127.0777563427458 37.62335269853286, 127.0777776914651 37.6232166182777, 127.0777959689489 37.62309659794587, 127.0778482882546 37.62275605999918, 127.0779070874375 37.62237770686568, 127.0780576441305 37.62184988513667, 127.078147226518 37.62161693187775, 127.0783142657128 37.62126037224358, 127.0785111268233 37.62101768624576, 127.0785559400178 37.6209761989048, 127.0786171806544 37.62092007112715, 127.079062046252 37.62052619514987, 127.0793051942698 37.62036144068242, 127.0795424922049 37.62022821183289, 127.0796404980882 37.6201801138707, 127.0796979814874 37.62015225084151, 127.0798897590067 37.62005932038478, 127.0800073845013 37.62001232850748, 127.0801609095515 37.61995099770535, 127.0803213193 37.61988847527781, 127.0807992586668 37.61978201307974, 127.0810323469284 37.61976611198904, 127.0816372327308 37.61925094176976, 127.0758492361736 37.61707830737428, 127.0714031371484 37.6156279752979, 127.0711870608496 37.61636856878375, 127.0711866848789 37.61643403641954, 127.0711766221859 37.61732181749483, 127.0711673369631 37.61807654063481, 127.0708313939844 37.62157027133259, 127.0700458788758 37.62355261615754, 127.0682580298699 37.62554819185238, 127.0671577675256 37.62645676840337, 127.0653507541347 37.62818971300955, 127.0649402994601 37.62861408360546, 127.0648440995457 37.62887372046137, 127.0646905926653 37.629288041129, 127.0643921726835 37.63078316429583, 127.0702974405061 37.63140308284097, 127.0713030206085 37.63108455495713)))"
176,서울특별시,은평구,녹번동,11380510,38158,18352,19806,"MULTIPOLYGON (((126.9499832328689 37.60970523279793, 126.9503770463146 37.6078785962168, 126.9503431872675 37.60784677085806, 126.9501011147523 37.60773635571702, 126.9500500769015 37.60771712666376, 126.9499875066078 37.60770205489867, 126.9497460160525 37.60768625354473, 126.9495151575932 37.60768855692434, 126.9494628687057 37.60769198145606, 126.9494188091048 37.60769486750094, 126.9493563154754 37.60771936275876, 126.9492935801962 37.60778323457329, 126.9491713667505 37.60793031441373, 126.9491438782578 37.6079706201925, 126.9491055087011 37.60802690098549, 126.9490599504816 37.60805936185869, 126.9489947238386 37.60807032407225, 126.9488127161764 37.60807285415055, 126.948778778131 37.60806593558934, 126.9487065778311 37.60803685912177, 126.9483892464171 37.60798074159637, 126.9483318112981 37.60799061318808, 126.9482666345474 37.6079948151871, 126.9481956400681 37.60792462944931, 126.9481250318088 37.60789725909523, 126.9480640386767 37.60785553296933, 126.9480308059831 37.60782708629694, 126.9480117745862 37.60779532872207, 126.9479741151066 37.60776386167027, 126.9479258885668 37.60772732651532, 126.947874421029 37.60769779220342, 126.9478324264117 37.60768953774848, 126.9477980568568 37.60768278814111, 126.9476642077659 37.60768441510962, 126.9474480079049 37.60771607658078, 126.9472456913044 37.6077838562578, 126.9472154134783 37.60779830712088, 126.9463415453883 37.6071013600132, 126.9459901969151 37.60635698037302, 126.945697716751 37.60582406901416, 126.9449164956078 37.60481991190772, 126.944815560011 37.60482056198827, 126.944721261347 37.60482132613355, 126.9441123930494 37.60482626535917, 126.9433448677402 37.60483157085814, 126.9426586449755 37.60483630894629, 126.9424927697047 37.60482778295803, 126.9424172781844 37.60482390207282, 126.9422660792675 37.60468573332015, 126.9404366263929 37.60286087376971, 126.9401738581319 37.60183210010364, 126.9410968739721 37.60111202276659, 126.9412081556263 37.60090749482427, 126.9410825845054 37.59989521880126, 126.9410337078674 37.59961887973849, 126.9409173859698 37.5990786512024, 126.9406775666979 37.59867077240743, 126.9405832429837 37.59859935741253, 126.939337170561 37.59783969854561, 126.9389952528805 37.59770847453429, 126.9389347196065 37.59769131729318, 126.9385995005301 37.59758556792347, 126.9381670320089 37.59809552279823, 126.9358412800768 37.60071981100945, 126.9355457621465 37.60084224391751, 126.9342726563832 37.60094205559073, 126.9285284718901 37.60148109560616, 126.9284533034781 37.60149031284119, 126.9283959377482 37.60149735389152, 126.927463325407 37.6016171279806, 126.9264353991537 37.60241966118954, 126.925500114687 37.60222577127334, 126.9251679792074 37.60215626512644, 126.9246744332315 37.60205274793077, 126.9240337566915 37.60191759478393, 126.9224370950309 37.60158326359811, 126.9224023965234 37.60158309378463, 126.9215420315695 37.60164538974566, 126.9206311219422 37.60173327270403, 126.922886127885 37.6063209644806, 126.9232638523185 37.60693337328207, 126.923347101018 37.60706787222627, 126.923378932981 37.60709172936189, 126.9238863592461 37.60747158451228, 126.9270735034462 37.60913542323184, 126.9273029645113 37.60903851556314, 126.9277595544141 37.60884513102583, 126.9280318532707 37.6087299621198, 126.9282974965687 37.60862421537853, 126.9288344542029 37.60841162086306, 126.9297325440584 37.6083844172738, 126.9307378679226 37.60850306501989, 126.9313608701743 37.6087990036516, 126.9313918630247 37.60882055977847, 126.931623663279 37.60897490398231, 126.9318507542429 37.60912141045252, 126.9319245460536 37.60916901385831, 126.9320016450512 37.60919517677179, 126.9328420511549 37.60947762870541, 126.9333003970472 37.60956943719705, 126.9337583820897 37.60966117007211, 126.940630530085 37.61081723758956, 126.9408568342994 37.61082678265027, 126.94144320947 37.61085150711622, 126.9421411025316 37.61061144684564, 126.9429538224868 37.6101646165738, 126.9499832328689 37.60970523279793)))"
177,서울특별시,은평구,불광1동,11380520,41048,19477,21571,"MULTIPOLYGON (((126.9531783556529 37.6251667633698, 126.9523509742518 37.62489477927635, 126.9521716017255 37.62482296632809, 126.9517163396734 37.62432855049023, 126.9512409857418 37.62279288595064, 126.9503316426087 37.61836196031351, 126.9503962440484 37.61612806862719, 126.9506921956554 37.61488672553985, 126.9509366778276 37.61235961031377, 126.9508466123509 37.61180036113672, 126.950633816386 37.61096446042617, 126.9499832328689 37.60970523279793, 126.9429538224868 37.6101646165738, 126.9421411025316 37.61061144684564, 126.94144320947 37.61085150711622, 126.9408568342994 37.61082678265027, 126.940630530085 37.61081723758956, 126.9337583820897 37.60966117007211, 126.9333003970472 37.60956943719705, 126.9328420511549 37.60947762870541, 126.9320016450512 37.60919517677179, 126.9319245460536 37.60916901385831, 126.9318507542429 37.60912141045252, 126.931623663279 37.60897490398231, 126.9313918630247 37.60882055977847, 126.9313608701743 37.6087990036516, 126.929893429344 37.6102485757342, 126.9297904965157 37.61057024555942, 126.9276062498983 37.61316924205875, 126.9267693644056 37.61416341120361, 126.9265758125186 37.61437766517521, 126.9263216701357 37.61462786705444, 126.9257270847764 37.61506644195242, 126.9253092847297 37.6153404425386, 126.9252409556456 37.61538517661646, 126.9250665232864 37.61549927443201, 126.9247348873276 37.61571620543253, 126.9239374031709 37.61627677653059, 126.9225905054843 37.61746345833922, 126.9225476883683 37.61750143575807, 126.9222887754119 37.61777781626832, 126.9221642139668 37.6179107935066, 126.9221306565199 37.61794668264839, 126.921934864057 37.61817218453003, 126.9219105680497 37.61820023227992, 126.9213310724095 37.61886995311087, 126.9226541118479 37.61955463197599, 126.925984094405 37.62124861050021, 126.9264168694461 37.6213318352837, 126.9335457724524 37.62172568045144, 126.9338705596328 37.62167090562299, 126.9342368408156 37.62156112198117, 126.9348119991186 37.62136445752832, 126.9348468007105 37.62135223083547, 126.9347780384242 37.62098573338552, 126.9350099953469 37.62084375702225, 126.9368929922651 37.62002240127372, 126.9375357106415 37.62016292056714, 126.9379622053903 37.62033169111444, 126.9383267439653 37.62054525010736, 126.9385702727171 37.6207469565507, 126.93881492278 37.62098810131675, 126.9388379452197 37.62103982136451, 126.9388852714769 37.621146169844, 126.9388988956694 37.62150000939491, 126.9389028557378 37.62201041025365, 126.9393468638709 37.6232439721595, 126.9396553161657 37.62394960662767, 126.9401027944316 37.62458770488043, 126.9403679999034 37.62496586589121, 126.94090563583 37.62570305429628, 126.9428909827184 37.62523130605364, 126.9462039920151 37.62678023769337, 126.9469261341228 37.62702817546525, 126.9481324330045 37.6274416513976, 126.9483465698871 37.62742235466517, 126.9485956571432 37.6273999039629, 126.9493316226719 37.62710477331258, 126.9531783556529 37.6251667633698)))"
178,서울특별시,은평구,갈현1동,11380551,24768,12080,12688,"MULTIPOLYGON (((126.9195761984846 37.62796376216917, 126.919907696871 37.62686801670907, 126.9199311220696 37.62678916588137, 126.9199447954908 37.62674313790844, 126.9201120808771 37.62599697841549, 126.9200655097395 37.62551791501676, 126.9200287718339 37.62514142682657, 126.9199726092833 37.62456898827558, 126.9199688354347 37.62453182928428, 126.9199459969918 37.62430835790364, 126.9199224186936 37.62408313608463, 126.9198866752235 37.6237402787895, 126.9197898483709 37.62280354002683, 126.9197477012511 37.62239435155671, 126.9198106213485 37.62195300627234, 126.9198566933829 37.62163084739479, 126.919863772545 37.62158371888348, 126.9199792909166 37.62109696763391, 126.9200585269505 37.62076446025621, 126.9203571236566 37.62016203206917, 126.9205050654283 37.61986659397582, 126.9205353438903 37.61982941382018, 126.9210852469658 37.61916620554231, 126.9212027639806 37.61902450604665, 126.9213310724095 37.61886995311087, 126.9201153613303 37.61846295153333, 126.9171079244159 37.61976639702683, 126.9122695771969 37.62254887441996, 126.9113948134852 37.62257321256742, 126.9079373629847 37.62539346274249, 126.9088107359685 37.62905050142664, 126.9091252205645 37.62905095007754, 126.9101862457824 37.62923201904225, 126.9108119389426 37.62946836548883, 126.9112208187525 37.62962363434702, 126.9120816140821 37.63040758110268, 126.9126062957552 37.63052060693992, 126.9127719226079 37.63055597052552, 126.9129047068503 37.63058405983355, 126.9154710247348 37.63111732241571, 126.9156456700303 37.63070470026983, 126.9195761984846 37.62796376216917)))"
179,서울특별시,은평구,갈현2동,11380552,30235,14392,15843,"MULTIPOLYGON (((126.9201153613303 37.61846295153333, 126.9180683668429 37.61531847556871, 126.9177815805594 37.61440783713925, 126.9175999888386 37.61335688316011, 126.9175200785907 37.61289360694811, 126.9172867784239 37.61129909774692, 126.9153476852911 37.61240835497949, 126.9120998765397 37.61361015121359, 126.9119361401434 37.61367045503636, 126.9118825499383 37.61369018863412, 126.9115977671836 37.61379242274462, 126.91117308745 37.61394465838872, 126.9110384749963 37.61399273092104, 126.9105694492497 37.61416021899581, 126.9101927107698 37.61429539929608, 126.9101475979125 37.61431246505285, 126.909333617202 37.61491834616378, 126.9092698916101 37.61496581604419, 126.9092068719092 37.61501284776862, 126.9088610604601 37.61527158421872, 126.9085839379034 37.61547975642142, 126.9079674160568 37.61594296235915, 126.9078212400492 37.61607109297218, 126.9068548387092 37.616935288018, 126.9068357207306 37.6169615668225, 126.9066101259268 37.61736716060491, 126.9063909771149 37.61776264631464, 126.9055947560421 37.61921204349191, 126.9052447250126 37.61949872435838, 126.9052044330957 37.62002465893854, 126.9064354123101 37.62402597775657, 126.9065960014813 37.62420235206705, 126.9070911715825 37.62474588576832, 126.9079373629847 37.62539346274249, 126.9113948134852 37.62257321256742, 126.9122695771969 37.62254887441996, 126.9171079244159 37.61976639702683, 126.9201153613303 37.61846295153333)))"
180,서울특별시,은평구,구산동,11380560,33843,16835,17008,"MULTIPOLYGON (((126.9172867784239 37.61129909774692, 126.9171102829653 37.61077326000498, 126.9168786672178 37.61032708024002, 126.916811692592 37.61019830864679, 126.9152478840148 37.60742796940909, 126.9118270207944 37.60752250999827, 126.9115252088422 37.60753148794166, 126.9094738282117 37.60539599385469, 126.9078990398487 37.60504108815817, 126.9076686003099 37.60499148485067, 126.907496042223 37.60496470516128, 126.9073828887154 37.6049472369193, 126.9050213931034 37.60468861363205, 126.9046441477881 37.60475769150517, 126.904597333647 37.6047664687114, 126.9045214617297 37.60478073264631, 126.9017148413566 37.60573097011439, 126.9022073893125 37.60709223275104, 126.9019836393331 37.60939063630221, 126.9018716446865 37.61000320336292, 126.9012066391464 37.61232956166548, 126.9011522431027 37.61236916077495, 126.9010313150983 37.61245709436633, 126.9018900654389 37.61559248504774, 126.9033926642164 37.6188020882067, 126.9052447250126 37.61949872435838, 126.9055947560421 37.61921204349191, 126.9063909771149 37.61776264631464, 126.9066101259268 37.61736716060491, 126.9068357207306 37.6169615668225, 126.9068548387092 37.616935288018, 126.9078212400492 37.61607109297218, 126.9079674160568 37.61594296235915, 126.9085839379034 37.61547975642142, 126.9088610604601 37.61527158421872, 126.9092068719092 37.61501284776862, 126.9092698916101 37.61496581604419, 126.909333617202 37.61491834616378, 126.9101475979125 37.61431246505285, 126.9101927107698 37.61429539929608, 126.9105694492497 37.61416021899581, 126.9110384749963 37.61399273092104, 126.91117308745 37.61394465838872, 126.9115977671836 37.61379242274462, 126.9118825499383 37.61369018863412, 126.9119361401434 37.61367045503636, 126.9120998765397 37.61361015121359, 126.9153476852911 37.61240835497949, 126.9172867784239 37.61129909774692)))"
181,서울특별시,은평구,대조동,11380570,29784,14013,15771,"MULTIPOLYGON (((126.9313608701743 37.6087990036516, 126.9307378679226 37.60850306501989, 126.9297325440584 37.6083844172738, 126.9288344542029 37.60841162086306, 126.9282974965687 37.60862421537853, 126.9280318532707 37.6087299621198, 126.9277595544141 37.60884513102583, 126.9273029645113 37.60903851556314, 126.9270735034462 37.60913542323184, 126.9238863592461 37.60747158451228, 126.923378932981 37.60709172936189, 126.923347101018 37.60706787222627, 126.9232638523185 37.60693337328207, 126.922886127885 37.6063209644806, 126.9218533651558 37.60747741484091, 126.9172867784239 37.61129909774692, 126.9175200785907 37.61289360694811, 126.9175999888386 37.61335688316011, 126.9177815805594 37.61440783713925, 126.9180683668429 37.61531847556871, 126.9201153613303 37.61846295153333, 126.9213310724095 37.61886995311087, 126.9219105680497 37.61820023227992, 126.921934864057 37.61817218453003, 126.9221306565199 37.61794668264839, 126.9221642139668 37.6179107935066, 126.9222887754119 37.61777781626832, 126.9225476883683 37.61750143575807, 126.9225905054843 37.61746345833922, 126.9239374031709 37.61627677653059, 126.9247348873276 37.61571620543253, 126.9250665232864 37.61549927443201, 126.9252409556456 37.61538517661646, 126.9253092847297 37.6153404425386, 126.9257270847764 37.61506644195242, 126.9263216701357 37.61462786705444, 126.9265758125186 37.61437766517521, 126.9267693644056 37.61416341120361, 126.9276062498983 37.61316924205875, 126.9297904965157 37.61057024555942, 126.929893429344 37.6102485757342, 126.9313608701743 37.6087990036516)))"
182,서울특별시,은평구,응암1동,11380580,25747,12290,13457,"MULTIPOLYGON (((126.9385995005301 37.59758556792347, 126.9377731528148 37.59774888348957, 126.933657829912 37.59639860372403, 126.9329540721837 37.59602680168368, 126.9306626769332 37.59449025154686, 126.9303750114074 37.59424212152852, 126.9292719358778 37.5930251653087, 126.9286478272391 37.5922609633575, 126.9284184181561 37.59189480951206, 126.9275959564223 37.5923180773417, 126.9266834382986 37.59288237642207, 126.9260539264566 37.59446686624201, 126.926049290656 37.59479464321572, 126.9260703356991 37.59500430721361, 126.9263314817 37.59561999353456, 126.9238523151115 37.59664520579398, 126.9225742178808 37.59687655383644, 126.9222344269447 37.59689808151365, 126.9190953248795 37.59600221691375, 126.9156949266874 37.5970783060428, 126.9160591913852 37.59921181660296, 126.9206311219422 37.60173327270403, 126.9215420315695 37.60164538974566, 126.9224023965234 37.60158309378463, 126.9224370950309 37.60158326359811, 126.9240337566915 37.60191759478393, 126.9246744332315 37.60205274793077, 126.9251679792074 37.60215626512644, 126.925500114687 37.60222577127334, 126.9264353991537 37.60241966118954, 126.927463325407 37.6016171279806, 126.9283959377482 37.60149735389152, 126.9284533034781 37.60149031284119, 126.9285284718901 37.60148109560616, 126.9342726563832 37.60094205559073, 126.9355457621465 37.60084224391751, 126.9358412800768 37.60071981100945, 126.9381670320089 37.59809552279823, 126.9385995005301 37.59758556792347)))"
183,서울특별시,은평구,응암2동,11380590,23882,11655,12227,"MULTIPOLYGON (((126.9284184181561 37.59189480951206, 126.9282645372408 37.5916507021316, 126.9282248072376 37.5915328305838, 126.9281607020538 37.59134261736836, 126.9281081372215 37.59118586373213, 126.9278700722509 37.59045304450205, 126.9278819552508 37.59039373165682, 126.9280215886952 37.58972403582415, 126.9281179957578 37.58943044035225, 126.9281210344363 37.5883848989784, 126.9273892526668 37.58789575251028, 126.9271920455236 37.58776410111312, 126.9265364219282 37.58740826770293, 126.9260738584007 37.5871705439511, 126.925942175478 37.58714115078857, 126.9235842389832 37.58614890873419, 126.9228195845558 37.58562233175042, 126.9226479865114 37.58876836323443, 126.9208732060415 37.58940300986604, 126.9187579863462 37.5901294497343, 126.9185629856978 37.59018202894372, 126.918401192714 37.59021895293326, 126.9182856772705 37.59020768475686, 126.918145827413 37.59019403414369, 126.9178252531742 37.59017780659262, 126.9174901897895 37.5902054470305, 126.9172508218918 37.59023689849621, 126.9182072013117 37.59476864069784, 126.9184404340703 37.595093145936, 126.9185356902757 37.59522543625592, 126.9190953248795 37.59600221691375, 126.9222344269447 37.59689808151365, 126.9225742178808 37.59687655383644, 126.9238523151115 37.59664520579398, 126.9263314817 37.59561999353456, 126.9260703356991 37.59500430721361, 126.926049290656 37.59479464321572, 126.9260539264566 37.59446686624201, 126.9266834382986 37.59288237642207, 126.9275959564223 37.5923180773417, 126.9284184181561 37.59189480951206)))"
184,서울특별시,은평구,신사1동,11380631,28658,13882,14776,"MULTIPOLYGON (((126.9160591913852 37.59921181660296, 126.9156949266874 37.5970783060428, 126.9144806512509 37.592296312749, 126.9125537489321 37.5938077495728, 126.9084606971789 37.59683851355159, 126.9060282946044 37.5981698334671, 126.9014177801957 37.59826638204022, 126.9014896752708 37.59936750673278, 126.9012287751947 37.60011767450636, 126.900872357737 37.60077046284059, 126.9007183220493 37.60099501540213, 126.9004772164888 37.60130700597566, 126.9002300106681 37.60202680440987, 126.9002605844124 37.60315477546994, 126.9020841673257 37.60382087778708, 126.9064601328981 37.60211232962467, 126.9076950071216 37.60157103800027, 126.9085557444561 37.60204968417376, 126.9088092745915 37.60204306774751, 126.90903236097 37.60203629833524, 126.9103197819823 37.60199429103104, 126.9132153117671 37.60117281685992, 126.9132851237729 37.60115054934558, 126.9136292564616 37.60101379594941, 126.9144143084687 37.6001297530913, 126.9160591913852 37.59921181660296)))"
185,서울특별시,은평구,신사2동,11380632,21998,10990,11008,"MULTIPOLYGON (((126.9144806512509 37.592296312749, 126.9135797656691 37.58872816468919, 126.9126853525811 37.58875565209685, 126.9107282421289 37.58927504763347, 126.9102054568783 37.58940651090251, 126.9054697830942 37.58873829366364, 126.9042795525721 37.58832105583863, 126.8998412385919 37.58986690482818, 126.8997766700142 37.58997361063567, 126.8995802045701 37.59046058338294, 126.8990065667427 37.59258860707561, 126.8989890913875 37.59265897581401, 126.8993348281291 37.59324322658576, 126.8999458669404 37.593772523239, 126.900556113967 37.59429724470199, 126.9013602578037 37.59617719367432, 126.9014177801957 37.59826638204022, 126.9060282946044 37.5981698334671, 126.9084606971789 37.59683851355159, 126.9125537489321 37.5938077495728, 126.9144806512509 37.592296312749)))"
186,서울특별시,은평구,증산동,11380640,16254,7986,8268,"MULTIPOLYGON (((126.9135797656691 37.58872816468919, 126.9131478717302 37.58703486264387, 126.9130831416448 37.586889209452, 126.9130539182294 37.58682372141029, 126.9129690083993 37.58663852421181, 126.9128234199543 37.58633697743024, 126.9126950635383 37.58618534074827, 126.9125526429695 37.58602241403393, 126.9123306482612 37.58580611375748, 126.9098495540533 37.58346602088266, 126.9062943026781 37.58011886250504, 126.9031269616782 37.57689188651241, 126.9028198155846 37.57714710835636, 126.9016384701362 37.5759187600103, 126.8985945773639 37.57799296302955, 126.8982002529728 37.57826168402391, 126.8987985415333 37.57876496474249, 126.8997153509773 37.57953571697347, 126.9001080913846 37.57981492928977, 126.9010869830153 37.58035169157303, 126.9013665735111 37.58044099062649, 126.9015876158837 37.58051138853074, 126.9020712062271 37.58066539069672, 126.9021544280744 37.58309267407439, 126.9016000863342 37.58398782626454, 126.901496821281 37.58415405081049, 126.9013464758937 37.58454199171813, 126.9013835568093 37.58486102915251, 126.9014166088709 37.58506512516008, 126.9015528232362 37.5855581733184, 126.9016571809964 37.58578629093721, 126.9023064509266 37.58692076309347, 126.9025559174345 37.58732875603925, 126.9029757275747 37.58764312264146, 126.9032603169049 37.58785622359255, 126.9042795525721 37.58832105583863, 126.9054697830942 37.58873829366364, 126.9102054568783 37.58940651090251, 126.9107282421289 37.58927504763347, 126.9126853525811 37.58875565209685, 126.9135797656691 37.58872816468919)))"
187,서울특별시,은평구,수색동,11380650,9094,4530,4564,"MULTIPOLYGON (((126.8998412385919 37.58986690482818, 126.9042795525721 37.58832105583863, 126.9032603169049 37.58785622359255, 126.9029757275747 37.58764312264146, 126.9025559174345 37.58732875603925, 126.9023064509266 37.58692076309347, 126.9016571809964 37.58578629093721, 126.9015528232362 37.5855581733184, 126.9014166088709 37.58506512516008, 126.9013835568093 37.58486102915251, 126.9013464758937 37.58454199171813, 126.901496821281 37.58415405081049, 126.9016000863342 37.58398782626454, 126.9021544280744 37.58309267407439, 126.9020712062271 37.58066539069672, 126.9015876158837 37.58051138853074, 126.9013665735111 37.58044099062649, 126.9010869830153 37.58035169157303, 126.9001080913846 37.57981492928977, 126.8997153509773 37.57953571697347, 126.8987985415333 37.57876496474249, 126.8982002529728 37.57826168402391, 126.897908384158 37.57916941155027, 126.8966632485242 37.58048853079705, 126.8962298368553 37.58085411699324, 126.8952926832612 37.58146303404953, 126.8921768677375 37.58293919097798, 126.890225144344 37.58423843470268, 126.8899697991227 37.58440600400859, 126.8899199553733 37.58444180002028, 126.8896534292146 37.58463747412624, 126.8894079244553 37.58481771545058, 126.8874406483675 37.58646711613211, 126.8869786781206 37.58686356073997, 126.8832548932839 37.59006307044694, 126.8822410175408 37.59093660473638, 126.8833793143638 37.591715426545, 126.8839311881036 37.59218362475302, 126.8841197414643 37.59241332358425, 126.8843194143112 37.59266674026388, 126.8848224764532 37.59339156125307, 126.8865809499389 37.59383560969486, 126.8862150273243 37.59232790142884, 126.8854418368198 37.59108838170808, 126.8858089864585 37.5900775171912, 126.886315523036 37.58943118745356, 126.8872618092997 37.58859447774934, 126.8874120111928 37.5885794821446, 126.8913978907285 37.58845588718365, 126.8969615159884 37.5886207710837, 126.8998412385919 37.58986690482818)))"
188,서울특별시,은평구,진관동,11380690,58038,27290,30748,"MULTIPOLYGON (((126.9717859078064 37.63228533903874, 126.970203682826 37.63086089310856, 126.969251985821 37.63022341331835, 126.9688193458448 37.63010318034924, 126.9683419758299 37.62998532567903, 126.9676293401856 37.62980938922137, 126.9623416153841 37.62885027553708, 126.9595422280759 37.62848258383033, 126.9574769848946 37.62617486919115, 126.9567529613507 37.62536579675913, 126.9531783556529 37.6251667633698, 126.9493316226719 37.62710477331258, 126.9485956571432 37.6273999039629, 126.9483465698871 37.62742235466517, 126.9481324330045 37.6274416513976, 126.9469261341228 37.62702817546525, 126.9462039920151 37.62678023769337, 126.9428909827184 37.62523130605364, 126.94090563583 37.62570305429628, 126.9403932828718 37.62603294277312, 126.93591214316 37.62639129272266, 126.9333326419927 37.6265715932251, 126.9321798310213 37.62644211742717, 126.9321212392752 37.62644144516998, 126.9320727788724 37.62645624891473, 126.931916502598 37.62657851995158, 126.9292185411678 37.62838259762309, 126.9268513859875 37.62948090984465, 126.9262325819924 37.62954436855157, 126.9261454166835 37.62955294267292, 126.9255831260359 37.62954345555511, 126.9195761984846 37.62796376216917, 126.9156456700303 37.63070470026983, 126.9154710247348 37.63111732241571, 126.9129047068503 37.63058405983355, 126.9127719226079 37.63055597052552, 126.9126062957552 37.63052060693992, 126.9120816140821 37.63040758110268, 126.9112208187525 37.62962363434702, 126.9108119389426 37.62946836548883, 126.9101862457824 37.62923201904225, 126.9091252205645 37.62905095007754, 126.9088107359685 37.62905050142664, 126.9074152965871 37.63021974270846, 126.9071688089355 37.63057565820677, 126.9066489470075 37.63172900608082, 126.9066332032049 37.63177913121284, 126.9065479251313 37.63205072492615, 126.906530709959 37.63252383868431, 126.9072281257891 37.63318531932139, 126.9072585391378 37.63321315208232, 126.9073160241893 37.63326575338426, 126.9074784968008 37.63341191042713, 126.9091733670793 37.63477917070227, 126.909816780278 37.63510912446462, 126.9102264257626 37.63866693340105, 126.910821720158 37.64016048647162, 126.9117111212592 37.64101555866684, 126.9121037621955 37.64126200156203, 126.9123043091513 37.64143199345529, 126.9124666881964 37.64168518354048, 126.9124671910609 37.64180123264447, 126.9122268253314 37.64437766361075, 126.9075842927784 37.64649416089275, 126.9052709088704 37.64891487343046, 126.9077715439509 37.6476262724931, 126.9111756400494 37.64580109904632, 126.9123684443925 37.64525284445479, 126.9128710946512 37.64505586427689, 126.9138867124568 37.64470720460874, 126.9141929733768 37.64468055914511, 126.9212689219586 37.6455576652439, 126.9215286265201 37.64564174891836, 126.9220876164626 37.64582362844642, 126.9221684000379 37.64585047826902, 126.9224282193847 37.64593683639262, 126.9233560236849 37.64634021482554, 126.9245417661374 37.64696413867379, 126.9251418258162 37.64729082287722, 126.9252227493285 37.64733516615598, 126.9254197925821 37.6474431502533, 126.9254980025938 37.64749986443505, 126.9256691966875 37.6476246402397, 126.9259889803892 37.64785819963789, 126.9269085319963 37.64852981861402, 126.9279427006091 37.6492851071305, 126.9285098965449 37.64969909812466, 126.9286089471629 37.64976761049073, 126.9286952557622 37.64982730912951, 126.9288947827273 37.6499646396109, 126.9297415434345 37.65040471754708, 126.9303943501792 37.6505554646042, 126.9311958372806 37.65062693181234, 126.9312667457891 37.65061938703708, 126.9344916054433 37.65056165722764, 126.9347347259751 37.65064168993396, 126.9351874242634 37.65089448185837, 126.937042539693 37.65193036444436, 126.9384973359341 37.65416133519427, 126.9385911961224 37.65442103655195, 126.9389650052042 37.65494679890347, 126.9392593415933 37.65534345137138, 126.9393793283577 37.65550062718215, 126.9403911820664 37.65662759522071, 126.941030606455 37.65706100831906, 126.9411917065506 37.65715427256852, 126.9425457553107 37.65778924276459, 126.9428185664003 37.65788291819812, 126.9436207799447 37.65815485089829, 126.9463158385795 37.65887395065719, 126.9465263215029 37.65890551162642, 126.9470760173636 37.65898792954575, 126.9473053154988 37.6589315442636, 126.9474193911577 37.65874054574379, 126.9474344464612 37.65871479672411, 126.9474489890776 37.65868127672331, 126.9475923417415 37.65835040229914, 126.9487919870708 37.65695697593488, 126.9511576995893 37.65501408986417, 126.9511913808052 37.65499105528681, 126.9512509836629 37.65495030392037, 126.9520728738661 37.65476146461712, 126.9523279880565 37.65473182376153, 126.9523600843097 37.65473003490806, 126.9525769554642 37.65472099167656, 126.9535482893535 37.65502293502215, 126.9546230281742 37.65475074904568, 126.9563428555311 37.65307432230728, 126.9567654040387 37.6526492624794, 126.9597488770857 37.64846387708788, 126.9617316944068 37.64515941183055, 126.9644204006815 37.64307266609734, 126.9647634685143 37.64294916286214, 126.9650056950492 37.64275985460243, 126.9682925603065 37.63931922058519, 126.9688234489138 37.63868166383, 126.9688614391391 37.63841932089598, 126.9687869266995 37.6370455752374, 126.968764042517 37.63697561867808, 126.970874212358 37.63299443554261, 126.9717859078064 37.63228533903874)))"
189,서울특별시,은평구,불광2동,11380530,29576,14407,15169,"MULTIPOLYGON (((126.94090563583 37.62570305429628, 126.9403679999034 37.62496586589121, 126.9401027944316 37.62458770488043, 126.9396553161657 37.62394960662767, 126.9393468638709 37.6232439721595, 126.9389028557378 37.62201041025365, 126.9388988956694 37.62150000939491, 126.9388852714769 37.621146169844, 126.9388379452197 37.62103982136451, 126.93881492278 37.62098810131675, 126.9385702727171 37.6207469565507, 126.9383267439653 37.62054525010736, 126.9379622053903 37.62033169111444, 126.9375357106415 37.62016292056714, 126.9368929922651 37.62002240127372, 126.9350099953469 37.62084375702225, 126.9347780384242 37.62098573338552, 126.9348468007105 37.62135223083547, 126.9348119991186 37.62136445752832, 126.9342368408156 37.62156112198117, 126.9338705596328 37.62167090562299, 126.9335457724524 37.62172568045144, 126.9264168694461 37.6213318352837, 126.925984094405 37.62124861050021, 126.9226541118479 37.61955463197599, 126.9213310724095 37.61886995311087, 126.9212027639806 37.61902450604665, 126.9210852469658 37.61916620554231, 126.9205353438903 37.61982941382018, 126.9205050654283 37.61986659397582, 126.9203571236566 37.62016203206917, 126.9200585269505 37.62076446025621, 126.9199792909166 37.62109696763391, 126.919863772545 37.62158371888348, 126.9198566933829 37.62163084739479, 126.9198106213485 37.62195300627234, 126.9197477012511 37.62239435155671, 126.9197898483709 37.62280354002683, 126.9198866752235 37.6237402787895, 126.9199224186936 37.62408313608463, 126.9199459969918 37.62430835790364, 126.9199688354347 37.62453182928428, 126.9199726092833 37.62456898827558, 126.9200287718339 37.62514142682657, 126.9200655097395 37.62551791501676, 126.9201120808771 37.62599697841549, 126.9199447954908 37.62674313790844, 126.9199311220696 37.62678916588137, 126.919907696871 37.62686801670907, 126.9195761984846 37.62796376216917, 126.9255831260359 37.62954345555511, 126.9261454166835 37.62955294267292, 126.9262325819924 37.62954436855157, 126.9268513859875 37.62948090984465, 126.9292185411678 37.62838259762309, 126.931916502598 37.62657851995158, 126.9320727788724 37.62645624891473, 126.9321212392752 37.62644144516998, 126.9321798310213 37.62644211742717, 126.9333326419927 37.6265715932251, 126.93591214316 37.62639129272266, 126.9403932828718 37.62603294277312, 126.94090563583 37.62570305429628)))"
190,서울특별시,은평구,응암3동,11380600,26193,12818,13375,"MULTIPOLYGON (((126.9190953248795 37.59600221691375, 126.9185356902757 37.59522543625592, 126.9184404340703 37.595093145936, 126.9182072013117 37.59476864069784, 126.9172508218918 37.59023689849621, 126.9174901897895 37.5902054470305, 126.9178252531742 37.59017780659262, 126.918145827413 37.59019403414369, 126.9182856772705 37.59020768475686, 126.918401192714 37.59021895293326, 126.9185629856978 37.59018202894372, 126.9187579863462 37.5901294497343, 126.9208732060415 37.58940300986604, 126.9226479865114 37.58876836323443, 126.9228195845558 37.58562233175042, 126.9230246567604 37.58500034492369, 126.9208147745925 37.5829123508116, 126.9196815929979 37.58332653290611, 126.9193675897712 37.58337577034244, 126.918907205906 37.58340726457005, 126.9167721590921 37.58324242126775, 126.9161202760548 37.5831434309428, 126.9159235224599 37.58313907750143, 126.9158250941179 37.58314422290373, 126.9156403521909 37.58412405391868, 126.9154426559969 37.58549291951925, 126.9131478717302 37.58703486264387, 126.9135797656691 37.58872816468919, 126.9144806512509 37.592296312749, 126.9156949266874 37.5970783060428, 126.9190953248795 37.59600221691375)))"
191,서울특별시,은평구,역촌동,11380625,48883,23231,25652,"MULTIPOLYGON (((126.922886127885 37.6063209644806, 126.9206311219422 37.60173327270403, 126.9160591913852 37.59921181660296, 126.9144143084687 37.6001297530913, 126.9136292564616 37.60101379594941, 126.9132851237729 37.60115054934558, 126.9132153117671 37.60117281685992, 126.9103197819823 37.60199429103104, 126.90903236097 37.60203629833524, 126.9088092745915 37.60204306774751, 126.9085557444561 37.60204968417376, 126.9076950071216 37.60157103800027, 126.9064601328981 37.60211232962467, 126.9020841673257 37.60382087778708, 126.9017148413566 37.60573097011439, 126.9045214617297 37.60478073264631, 126.904597333647 37.6047664687114, 126.9046441477881 37.60475769150517, 126.9050213931034 37.60468861363205, 126.9073828887154 37.6049472369193, 126.907496042223 37.60496470516128, 126.9076686003099 37.60499148485067, 126.9078990398487 37.60504108815817, 126.9094738282117 37.60539599385469, 126.9115252088422 37.60753148794166, 126.9118270207944 37.60752250999827, 126.9152478840148 37.60742796940909, 126.916811692592 37.61019830864679, 126.9168786672178 37.61032708024002, 126.9171102829653 37.61077326000498, 126.9172867784239 37.61129909774692, 126.9218533651558 37.60747741484091, 126.922886127885 37.6063209644806)))"
192,서울특별시,서대문구,천연동,11410520,18803,8974,9829,"MULTIPOLYGON (((126.9595707378107 37.57296121845079, 126.9618982600831 37.57065058360018, 126.9658121875202 37.56666901462727, 126.9655142790289 37.56666762119831, 126.9634090662682 37.56633921113185, 126.9629545987368 37.56624585627303, 126.962742230296 37.56616604925539, 126.962580149133 37.5659715220914, 126.962543247685 37.56589506505379, 126.9589364470886 37.56554026072097, 126.9564122805703 37.56677702966572, 126.9536674404707 37.56934444310723, 126.9536948754878 37.5705264762909, 126.9517751024556 37.57173326586425, 126.950818000734 37.57388190465645, 126.9507808445434 37.57489349106998, 126.952222444462 37.57742846023881, 126.9526406526693 37.57795340509013, 126.9527857281145 37.57812511675392, 126.9528098681569 37.57815368408908, 126.9528809306952 37.57823347867264, 126.9532920742165 37.57838095692694, 126.9537556510646 37.57848450422745, 126.9539239562055 37.57849071623524, 126.9595707378107 37.57296121845079)))"
193,서울특별시,서대문구,홍제1동,11410620,25045,11776,13269,"MULTIPOLYGON (((126.9418413457908 37.59093153094467, 126.9447465560565 37.58816233121639, 126.9449824786672 37.5880790039672, 126.9454474520323 37.58770481413859, 126.9454766566571 37.58768129020767, 126.9482801310253 37.58497687861492, 126.9491252529987 37.58412454998575, 126.9492472149256 37.58400118444283, 126.9494432452243 37.58379370841824, 126.9496624372002 37.58356146387859, 126.9520959452292 37.58029978028771, 126.9535560166695 37.57887566580947, 126.9539239562055 37.57849071623524, 126.9537556510646 37.57848450422745, 126.9532920742165 37.57838095692694, 126.9528809306952 37.57823347867264, 126.9528098681569 37.57815368408908, 126.9527857281145 37.57812511675392, 126.9526406526693 37.57795340509013, 126.952222444462 37.57742846023881, 126.9507808445434 37.57489349106998, 126.950818000734 37.57388190465645, 126.9517751024556 37.57173326586425, 126.9536948754878 37.5705264762909, 126.9536674404707 37.56934444310723, 126.9496922384648 37.56845618588184, 126.9489411605683 37.56943628807204, 126.9476715574765 37.57279006860558, 126.9477182262103 37.57297623886139, 126.9478067351287 37.57316368192099, 126.947838875766 37.57322016629827, 126.9478616627565 37.57324900323911, 126.947893656206 37.57327788323353, 126.9485379249885 37.57382620814369, 126.9485766413221 37.57385568269773, 126.9487928989206 37.57399640107598, 126.949047099628 37.57465444255561, 126.9490753832933 37.57552211853606, 126.9490554567076 37.5755936824108, 126.9490390316985 37.5756526438039, 126.9489529316726 37.57571533601866, 126.9475242583264 37.57612220401468, 126.9467513512501 37.57681256593307, 126.9459066127002 37.57694942893294, 126.9451311179857 37.57720042587319, 126.9447101771981 37.57745982721375, 126.9418707414623 37.58082873669133, 126.9408425784141 37.58390646283884, 126.9371939017673 37.58254310851469, 126.9369445220722 37.58288969601466, 126.9363742478445 37.58374662993023, 126.9363090802505 37.58384546642289, 126.9360627068704 37.58422510682426, 126.935973966855 37.58436924013265, 126.9359243963775 37.58444978156757, 126.9358698908659 37.58454414852113, 126.9358052851029 37.58466215444947, 126.9357327056857 37.58480489561792, 126.9356859917195 37.58489705989014, 126.9355845942363 37.58512880143346, 126.9355531486189 37.58520283604629, 126.9355411566934 37.58523549742694, 126.9355139479665 37.58531465388619, 126.9354832428406 37.5854053488244, 126.9354548929847 37.58550436088689, 126.9354315605336 37.5855943835165, 126.9353977732558 37.58575646351093, 126.9353861512256 37.58583535197761, 126.9353767921458 37.58590854577063, 126.9353639901996 37.58601093108657, 126.9353614802766 37.58606131312191, 126.9353581556923 37.58612807766047, 126.9353607604374 37.58634553891663, 126.9353639335432 37.58637829985557, 126.935371269449 37.58645375024378, 126.9353806011896 37.58653038642916, 126.935383939006 37.58655633851484, 126.9354083503346 37.58669841666401, 126.9354336454829 37.58681796548059, 126.9354660592381 37.58693078827113, 126.9354992291756 37.58703798127961, 126.9355366763922 37.58713493655838, 126.9355638171629 37.58720391265425, 126.9356118111673 37.58730995519591, 126.9356620833463 37.58740831114829, 126.9357276804226 37.58753368595957, 126.9358226943482 37.5876783764914, 126.9358914891005 37.58777783127869, 126.9360232969397 37.58794746275642, 126.9360498557421 37.58797777559521, 126.9361026141671 37.58803797590797, 126.936123680897 37.58806061009891, 126.9361882884474 37.58812964604883, 126.9362810248664 37.58822360321003, 126.936367506415 37.58830515951216, 126.9364462271417 37.58837649353313, 126.9365029452452 37.58842537368969, 126.9365566587283 37.58847166163827, 126.9366094306882 37.58851363665412, 126.9366692510762 37.58856120656547, 126.9367378663319 37.58861559650725, 126.9368022481775 37.58866662223092, 126.9369325102639 37.5887607579257, 126.9370409749086 37.58883450932377, 126.9371566631328 37.5889116841134, 126.9372315084657 37.58896160577977, 126.9374692911345 37.58911371402142, 126.937620348335 37.58920668618252, 126.9377941362939 37.58931355695188, 126.939446873898 37.59029486675541, 126.9395449158987 37.59035286858207, 126.9404618227139 37.59089344143039, 126.9406042065947 37.5909763637591, 126.9406635532009 37.59101065263321, 126.9407162794766 37.59104111545904, 126.9408192058313 37.5910990636579, 126.9409905787902 37.59118775624077, 126.9410536836552 37.5912193767202, 126.9412085120474 37.59129694920167, 126.9414512710177 37.59140062585952, 126.9418413457908 37.59093153094467)))"
194,서울특별시,서대문구,홍제3동,11410640,16534,8036,8498,"MULTIPOLYGON (((126.9563034580664 37.59566236563108, 126.956309289704 37.59554294220439, 126.9563125845426 37.59547761011785, 126.956329141603 37.5951498224761, 126.9564987063107 37.59470677017237, 126.9567657600107 37.5940105098196, 126.9572501681026 37.59314470375023, 126.9575146001883 37.59267208033364, 126.9579290613135 37.58879364348915, 126.9574735302318 37.58760184035394, 126.9571722339032 37.5864676031894, 126.9568940006547 37.58542010468457, 126.9518218559402 37.58881507393819, 126.9514342529786 37.58915465749061, 126.9509943021439 37.58929570005701, 126.9465730938496 37.58894042953435, 126.946363972604 37.58888311494277, 126.945943802166 37.58874143533361, 126.9456795846457 37.58865227605821, 126.9456380482383 37.58863747112694, 126.9454788574813 37.58852968986761, 126.9449824786672 37.5880790039672, 126.9447465560565 37.58816233121639, 126.9418413457908 37.59093153094467, 126.9424921934909 37.59112870910402, 126.9429255525272 37.59125999683494, 126.9445247500241 37.59174524675384, 126.9445804102919 37.59176986294349, 126.9446715227303 37.59181015800493, 126.9469512887574 37.59437053136515, 126.947031579055 37.59446542672514, 126.9470619225177 37.59450414178779, 126.9472003170611 37.59468266076948, 126.9472238284183 37.59482879719722, 126.9472354778874 37.59490168013571, 126.9472113280036 37.59520323694675, 126.9471095811892 37.59552426337213, 126.9470152779097 37.59567326935043, 126.946788917135 37.59602936589877, 126.9465983699391 37.59632929519678, 126.9464902841747 37.59668031135514, 126.9465104356984 37.59701840873202, 126.9465135694362 37.59706560862748, 126.9465369120909 37.59716484757118, 126.9465665454902 37.5972811874046, 126.9466171292585 37.5974290191654, 126.9467415860716 37.59773718522541, 126.9467686996047 37.59780378621127, 126.9468391190445 37.59795171084416, 126.9469137169771 37.59810754174602, 126.9469427951565 37.59813832359826, 126.9471083178191 37.59831350766965, 126.947137487448 37.59834419976772, 126.9471634208235 37.59836062650153, 126.947367010927 37.59846794720121, 126.9475048415204 37.59850013943169, 126.9475543175927 37.59851163779214, 126.9476625762799 37.59852003121758, 126.9480245969472 37.59853424992839, 126.948362138254 37.59851428964291, 126.9486634974723 37.59845373063226, 126.9491232058416 37.59832968952298, 126.9494666614667 37.59822425788987, 126.9496861628317 37.59812500740347, 126.9498389084945 37.59805473892465, 126.9500321007327 37.59788433046486, 126.9500633865054 37.59785636342216, 126.9501993004272 37.59764408187291, 126.9504143432856 37.59730818017636, 126.9513879043828 37.5956983894372, 126.9563034580664 37.59566236563108)))"
195,서울특별시,서대문구,홍제2동,11410655,14629,6980,7649,"MULTIPOLYGON (((126.9568940006547 37.58542010468457, 126.9578953246189 37.58381141046542, 126.960673532739 37.58079784202972, 126.9587770618443 37.58161817291028, 126.9582688263123 37.58169718780316, 126.9571248221667 37.58161531779484, 126.9570018884703 37.58158320532254, 126.9564576046438 37.58128325688558, 126.9557948399294 37.58072925682743, 126.9557693336816 37.5800494854105, 126.9557685512201 37.58002395123692, 126.9557464595567 37.57930378371988, 126.9555571096007 37.57908687190313, 126.9554551445703 37.57897006960425, 126.954952872627 37.57893057107094, 126.9548098422277 37.57892481797071, 126.9541617505335 37.57889874854087, 126.9535560166695 37.57887566580947, 126.9520959452292 37.58029978028771, 126.9496624372002 37.58356146387859, 126.9494432452243 37.58379370841824, 126.9492472149256 37.58400118444283, 126.9491252529987 37.58412454998575, 126.9482801310253 37.58497687861492, 126.9454766566571 37.58768129020767, 126.9454474520323 37.58770481413859, 126.9449824786672 37.5880790039672, 126.9454788574813 37.58852968986761, 126.9456380482383 37.58863747112694, 126.9456795846457 37.58865227605821, 126.945943802166 37.58874143533361, 126.946363972604 37.58888311494277, 126.9465730938496 37.58894042953435, 126.9509943021439 37.58929570005701, 126.9514342529786 37.58915465749061, 126.9518218559402 37.58881507393819, 126.9568940006547 37.58542010468457)))"
196,서울특별시,서대문구,홍은1동,11410660,22758,11017,11741,"MULTIPOLYGON (((126.9533763212498 37.6053662840508, 126.953437334822 37.60517402329219, 126.9535426442699 37.60461905925903, 126.9535404349719 37.60457416229261, 126.9535364786087 37.60449397067246, 126.9535126620146 37.60426514533311, 126.9532648304203 37.60320266846133, 126.9532010847255 37.6030119658938, 126.9530814529544 37.60291113744483, 126.9530121446462 37.602868930049, 126.9528819566848 37.60278965850004, 126.9528019847456 37.60269470558269, 126.9527796388438 37.60225851907352, 126.9527771863469 37.60220668152909, 126.9527652458912 37.60144420027711, 126.9527627115309 37.60128120722582, 126.9527493088157 37.60040612359548, 126.9535085397932 37.59911847091431, 126.9538258579366 37.59881010385266, 126.9539356713675 37.5987035777452, 126.9539741538578 37.59866633211085, 126.9540932631613 37.59855107881121, 126.9555175721675 37.59848329764554, 126.9561323141599 37.59845796517131, 126.9561270983189 37.59851621283899, 126.9561238430308 37.5985525669517, 126.9562140547738 37.59859548988152, 126.9563510378744 37.5986606479587, 126.9567312084226 37.59866465188733, 126.9568833626137 37.59863292191683, 126.9569671211288 37.59861381582601, 126.9570548804556 37.59855234702035, 126.957100419579 37.59845887110827, 126.9571353789436 37.59838709587642, 126.9571456362435 37.59824292846682, 126.9570418857109 37.59790557493377, 126.9569833922861 37.59771780881644, 126.9569540128279 37.59762350150384, 126.9566126544457 37.59653656214865, 126.9563034580664 37.59566236563108, 126.9513879043828 37.5956983894372, 126.9504143432856 37.59730818017636, 126.9501993004272 37.59764408187291, 126.9500633865054 37.59785636342216, 126.9500321007327 37.59788433046486, 126.9498389084945 37.59805473892465, 126.9496861628317 37.59812500740347, 126.9494666614667 37.59822425788987, 126.9491232058416 37.59832968952298, 126.9486634974723 37.59845373063226, 126.948362138254 37.59851428964291, 126.9480245969472 37.59853424992839, 126.9476625762799 37.59852003121758, 126.9475543175927 37.59851163779214, 126.9475048415204 37.59850013943169, 126.947367010927 37.59846794720121, 126.9471634208235 37.59836062650153, 126.947137487448 37.59834419976772, 126.9471083178191 37.59831350766965, 126.9469427951565 37.59813832359826, 126.9469137169771 37.59810754174602, 126.9468391190445 37.59795171084416, 126.9467686996047 37.59780378621127, 126.9467415860716 37.59773718522541, 126.9466171292585 37.5974290191654, 126.9465665454902 37.5972811874046, 126.9465369120909 37.59716484757118, 126.9465135694362 37.59706560862748, 126.9465104356984 37.59701840873202, 126.9464902841747 37.59668031135514, 126.9465983699391 37.59632929519678, 126.946788917135 37.59602936589877, 126.9470152779097 37.59567326935043, 126.9471095811892 37.59552426337213, 126.9472113280036 37.59520323694675, 126.9472354778874 37.59490168013571, 126.9472238284183 37.59482879719722, 126.9472003170611 37.59468266076948, 126.9470619225177 37.59450414178779, 126.947031579055 37.59446542672514, 126.9469512887574 37.59437053136515, 126.9446715227303 37.59181015800493, 126.9445804102919 37.59176986294349, 126.9445247500241 37.59174524675384, 126.9429255525272 37.59125999683494, 126.9424921934909 37.59112870910402, 126.9418413457908 37.59093153094467, 126.9414512710177 37.59140062585952, 126.9409627984924 37.59395586950879, 126.9408693894548 37.59434143541234, 126.9406431514092 37.59466416121632, 126.9404592444322 37.59492467840068, 126.9400470824165 37.59531818705842, 126.940015575891 37.59534971069842, 126.9399878714583 37.59537874664223, 126.9393847873992 37.59602259565284, 126.9389894137075 37.59663024867548, 126.9385995005301 37.59758556792347, 126.9389347196065 37.59769131729318, 126.9389952528805 37.59770847453429, 126.939337170561 37.59783969854561, 126.9405832429837 37.59859935741253, 126.9406775666979 37.59867077240743, 126.9409173859698 37.5990786512024, 126.9410337078674 37.59961887973849, 126.9410825845054 37.59989521880126, 126.9412081556263 37.60090749482427, 126.9410968739721 37.60111202276659, 126.9401738581319 37.60183210010364, 126.9404366263929 37.60286087376971, 126.9422660792675 37.60468573332015, 126.9424172781844 37.60482390207282, 126.9424927697047 37.60482778295803, 126.9426586449755 37.60483630894629, 126.9433448677402 37.60483157085814, 126.9441123930494 37.60482626535917, 126.944721261347 37.60482132613355, 126.944815560011 37.60482056198827, 126.9449164956078 37.60481991190772, 126.945697716751 37.60582406901416, 126.9459901969151 37.60635698037302, 126.9463415453883 37.6071013600132, 126.9472154134783 37.60779830712088, 126.9472456913044 37.6077838562578, 126.9474480079049 37.60771607658078, 126.9476642077659 37.60768441510962, 126.9477980568568 37.60768278814111, 126.9478324264117 37.60768953774848, 126.947874421029 37.60769779220342, 126.9479258885668 37.60772732651532, 126.9479741151066 37.60776386167027, 126.9480117745862 37.60779532872207, 126.9480308059831 37.60782708629694, 126.9480640386767 37.60785553296933, 126.9481250318088 37.60789725909523, 126.9481956400681 37.60792462944931, 126.9482666345474 37.6079948151871, 126.9483318112981 37.60799061318808, 126.9483892464171 37.60798074159637, 126.9487065778311 37.60803685912177, 126.948778778131 37.60806593558934, 126.9488127161764 37.60807285415055, 126.9489947238386 37.60807032407225, 126.9490599504816 37.60805936185869, 126.9491055087011 37.60802690098549, 126.9491438782578 37.6079706201925, 126.9491713667505 37.60793031441373, 126.9492935801962 37.60778323457329, 126.9493563154754 37.60771936275876, 126.9494188091048 37.60769486750094, 126.9494628687057 37.60769198145606, 126.9495151575932 37.60768855692434, 126.9497460160525 37.60768625354473, 126.9499875066078 37.60770205489867, 126.9500500769015 37.60771712666376, 126.9501011147523 37.60773635571702, 126.9503431872675 37.60784677085806, 126.9503770463146 37.6078785962168, 126.9507368785767 37.60832020359569, 126.9531212637721 37.6055973155072, 126.9533763212498 37.6053662840508)))"
197,서울특별시,서대문구,홍은2동,11410685,28402,13774,14628,"MULTIPOLYGON (((126.9385995005301 37.59758556792347, 126.9389894137075 37.59663024867548, 126.9393847873992 37.59602259565284, 126.9399878714583 37.59537874664223, 126.940015575891 37.59534971069842, 126.9400470824165 37.59531818705842, 126.9404592444322 37.59492467840068, 126.9406431514092 37.59466416121632, 126.9408693894548 37.59434143541234, 126.9409627984924 37.59395586950879, 126.9414512710177 37.59140062585952, 126.9412085120474 37.59129694920167, 126.9410536836552 37.5912193767202, 126.9409905787902 37.59118775624077, 126.9408192058313 37.5910990636579, 126.9407162794766 37.59104111545904, 126.9406635532009 37.59101065263321, 126.9406042065947 37.5909763637591, 126.9404618227139 37.59089344143039, 126.9395449158987 37.59035286858207, 126.939446873898 37.59029486675541, 126.9377941362939 37.58931355695188, 126.937620348335 37.58920668618252, 126.9374692911345 37.58911371402142, 126.9372315084657 37.58896160577977, 126.9371566631328 37.5889116841134, 126.9370409749086 37.58883450932377, 126.9369325102639 37.5887607579257, 126.9368022481775 37.58866662223092, 126.9367378663319 37.58861559650725, 126.9366692510762 37.58856120656547, 126.9366094306882 37.58851363665412, 126.9365566587283 37.58847166163827, 126.9365029452452 37.58842537368969, 126.9364462271417 37.58837649353313, 126.936367506415 37.58830515951216, 126.9362810248664 37.58822360321003, 126.9361882884474 37.58812964604883, 126.936123680897 37.58806061009891, 126.9361026141671 37.58803797590797, 126.9360498557421 37.58797777559521, 126.9360232969397 37.58794746275642, 126.9358914891005 37.58777783127869, 126.9358226943482 37.5876783764914, 126.9357276804226 37.58753368595957, 126.9356620833463 37.58740831114829, 126.9356118111673 37.58730995519591, 126.9355638171629 37.58720391265425, 126.9355366763922 37.58713493655838, 126.9354992291756 37.58703798127961, 126.9354660592381 37.58693078827113, 126.9354336454829 37.58681796548059, 126.9354083503346 37.58669841666401, 126.935383939006 37.58655633851484, 126.9353806011896 37.58653038642916, 126.935371269449 37.58645375024378, 126.9353639335432 37.58637829985557, 126.9353607604374 37.58634553891663, 126.9353581556923 37.58612807766047, 126.9353614802766 37.58606131312191, 126.9353639901996 37.58601093108657, 126.9353767921458 37.58590854577063, 126.9353861512256 37.58583535197761, 126.9353977732558 37.58575646351093, 126.9354315605336 37.5855943835165, 126.9354548929847 37.58550436088689, 126.9354832428406 37.5854053488244, 126.9355139479665 37.58531465388619, 126.9355411566934 37.58523549742694, 126.9355531486189 37.58520283604629, 126.9355845942363 37.58512880143346, 126.9356859917195 37.58489705989014, 126.9357327056857 37.58480489561792, 126.9358052851029 37.58466215444947, 126.9358698908659 37.58454414852113, 126.9359243963775 37.58444978156757, 126.935973966855 37.58436924013265, 126.9360627068704 37.58422510682426, 126.9363090802505 37.58384546642289, 126.9363742478445 37.58374662993023, 126.9369445220722 37.58288969601466, 126.9371939017673 37.58254310851469, 126.9374826550975 37.58235145604881, 126.9375713761638 37.58222569081676, 126.9378070725512 37.58185275631207, 126.9379022572466 37.58161882439316, 126.9378248297093 37.58137400243622, 126.937705853039 37.581098526125, 126.9375941604428 37.58089068511891, 126.9374959735545 37.5807724928503, 126.9373896461105 37.58064723573001, 126.9370470710063 37.58041036542142, 126.9366257311764 37.58015147247001, 126.9354939331728 37.57967736783478, 126.9352362600076 37.57958712766527, 126.9343686140331 37.5792844033868, 126.9333124922721 37.57891542069656, 126.9332616670297 37.57889714982642, 126.9321024395195 37.57840597992374, 126.9304539136457 37.57756992753371, 126.9304116092619 37.5775483165117, 126.9299244272257 37.57729584200057, 126.9280899754111 37.57634393819279, 126.9278270140534 37.57620746239819, 126.9273061167108 37.57593673721672, 126.9270759701012 37.57630747416142, 126.9270286696951 37.57638385876675, 126.9268178506748 37.57673999258025, 126.9256610999288 37.57869929805952, 126.9251977368321 37.57950026981874, 126.9244979563424 37.58185058740978, 126.9246205175163 37.58257225785764, 126.9243108661845 37.58323997753399, 126.9242829339431 37.58329957234517, 126.9242259373463 37.58340162371182, 126.9241731094549 37.58349620523195, 126.9241515790062 37.58353440723783, 126.9239259634899 37.58386906529711, 126.9232106898525 37.58428468730901, 126.9230246567604 37.58500034492369, 126.9228195845558 37.58562233175042, 126.9235842389832 37.58614890873419, 126.925942175478 37.58714115078857, 126.9260738584007 37.5871705439511, 126.9265364219282 37.58740826770293, 126.9271920455236 37.58776410111312, 126.9273892526668 37.58789575251028, 126.9281210344363 37.5883848989784, 126.9281179957578 37.58943044035225, 126.9280215886952 37.58972403582415, 126.9278819552508 37.59039373165682, 126.9278700722509 37.59045304450205, 126.9281081372215 37.59118586373213, 126.9281607020538 37.59134261736836, 126.9282248072376 37.5915328305838, 126.9282645372408 37.5916507021316, 126.9284184181561 37.59189480951206, 126.9286478272391 37.5922609633575, 126.9292719358778 37.5930251653087, 126.9303750114074 37.59424212152852, 126.9306626769332 37.59449025154686, 126.9329540721837 37.59602680168368, 126.933657829912 37.59639860372403, 126.9377731528148 37.59774888348957, 126.9385995005301 37.59758556792347)))"
198,서울특별시,서대문구,남가좌1동,11410690,17029,8221,8808,"MULTIPOLYGON (((126.9218948872328 37.57190618764044, 126.9168544015975 37.56788732253502, 126.9118051132751 37.57027898846455, 126.9117198093933 37.57050278524509, 126.9112839684521 37.57217586386798, 126.9113959824845 37.57258114809347, 126.9132492886459 37.57374621985886, 126.915132247384 37.57516161863514, 126.9170187548865 37.57503916944894, 126.9218948872328 37.57190618764044)))"
199,서울특별시,서대문구,남가좌2동,11410700,25729,12324,13405,"MULTIPOLYGON (((126.9273061167108 37.57593673721672, 126.9218948872328 37.57190618764044, 126.9170187548865 37.57503916944894, 126.915132247384 37.57516161863514, 126.9145300405971 37.57524091434467, 126.9149693059249 37.57626499596264, 126.9155607103439 37.57838946084114, 126.9181010866654 37.58048185881091, 126.9190298755233 37.58055966689597, 126.9215317554075 37.58087953711908, 126.9215232579761 37.58102647918416, 126.9211243490303 37.58246201488357, 126.9210621740733 37.58258833680888, 126.9209187880226 37.58278441087138, 126.9208147745925 37.5829123508116, 126.9230246567604 37.58500034492369, 126.9232106898525 37.58428468730901, 126.9239259634899 37.58386906529711, 126.9241515790062 37.58353440723783, 126.9241731094549 37.58349620523195, 126.9242259373463 37.58340162371182, 126.9242829339431 37.58329957234517, 126.9243108661845 37.58323997753399, 126.9246205175163 37.58257225785764, 126.9244979563424 37.58185058740978, 126.9251977368321 37.57950026981874, 126.9256610999288 37.57869929805952, 126.9268178506748 37.57673999258025, 126.9270286696951 37.57638385876675, 126.9270759701012 37.57630747416142, 126.9273061167108 37.57593673721672)))"
200,서울특별시,서대문구,북가좌1동,11410710,19188,9289,9899,"MULTIPOLYGON (((126.9145300405971 37.57524091434467, 126.915132247384 37.57516161863514, 126.9132492886459 37.57374621985886, 126.9113959824845 37.57258114809347, 126.9112839684521 37.57217586386798, 126.9117198093933 37.57050278524509, 126.9118051132751 37.57027898846455, 126.9047785603159 37.57339284870578, 126.9016074451945 37.57546229817317, 126.9031269616782 37.57689188651241, 126.9062943026781 37.58011886250504, 126.9074882688068 37.57933506074689, 126.9101172910227 37.57756278405852, 126.9106909814459 37.57711914422373, 126.9108895992366 37.57696575365312, 126.9112635437118 37.57667696330307, 126.9113341596372 37.57662324212297, 126.9127785206266 37.57556121091118, 126.913286627275 37.57539248223926, 126.9145300405971 37.57524091434467)))"
201,서울특별시,서대문구,북가좌2동,11410720,33955,16486,17469,"MULTIPOLYGON (((126.9208147745925 37.5829123508116, 126.9209187880226 37.58278441087138, 126.9210621740733 37.58258833680888, 126.9211243490303 37.58246201488357, 126.9215232579761 37.58102647918416, 126.9215317554075 37.58087953711908, 126.9190298755233 37.58055966689597, 126.9181010866654 37.58048185881091, 126.9155607103439 37.57838946084114, 126.9149693059249 37.57626499596264, 126.9145300405971 37.57524091434467, 126.913286627275 37.57539248223926, 126.9127785206266 37.57556121091118, 126.9113341596372 37.57662324212297, 126.9112635437118 37.57667696330307, 126.9108895992366 37.57696575365312, 126.9106909814459 37.57711914422373, 126.9101172910227 37.57756278405852, 126.9074882688068 37.57933506074689, 126.9062943026781 37.58011886250504, 126.9098495540533 37.58346602088266, 126.9123306482612 37.58580611375748, 126.9125526429695 37.58602241403393, 126.9126950635383 37.58618534074827, 126.9128234199543 37.58633697743024, 126.9129690083993 37.58663852421181, 126.9130539182294 37.58682372141029, 126.9130831416448 37.586889209452, 126.9131478717302 37.58703486264387, 126.9154426559969 37.58549291951925, 126.9156403521909 37.58412405391868, 126.9158250941179 37.58314422290373, 126.9159235224599 37.58313907750143, 126.9161202760548 37.5831434309428, 126.9167721590921 37.58324242126775, 126.918907205906 37.58340726457005, 126.9193675897712 37.58337577034244, 126.9196815929979 37.58332653290611, 126.9208147745925 37.5829123508116)))"
202,서울특별시,서대문구,충현동,11410565,18242,8845,9397,"MULTIPOLYGON (((126.9658121875202 37.56666901462727, 126.9667735382637 37.56579436403002, 126.9695924617563 37.56201362245151, 126.9688994469641 37.56186068414217, 126.9680819597247 37.56167898870061, 126.9679222803674 37.56164334197116, 126.9673819387459 37.5614955534074, 126.9669014319327 37.56130638041186, 126.9666124906869 37.561132677408, 126.9665350198628 37.56108049991978, 126.9661874679054 37.5608457063168, 126.9655385971901 37.56038383445967, 126.9652380139032 37.5601710326246, 126.9643282875138 37.55965012922717, 126.9641821532124 37.55956741736362, 126.9638741663953 37.55940884226382, 126.9637585361085 37.55934972955886, 126.9637104077843 37.55933653155207, 126.9636582475572 37.55932223359292, 126.9636095048223 37.55930961772834, 126.9620679010407 37.5592609165609, 126.9592887055219 37.56188180294935, 126.9592269366924 37.56197000525246, 126.9581929693813 37.56188076346466, 126.9580522947985 37.56185983749907, 126.9554686476701 37.56146375032623, 126.9534307376993 37.56115125561123, 126.952529302703 37.56093976926214, 126.9506837895054 37.5602563136864, 126.9498647705398 37.5598097397557, 126.9495954779298 37.56019895885193, 126.9495112900011 37.56053365097196, 126.9492154277333 37.56515617738945, 126.9496803002302 37.56613067300717, 126.9500011058816 37.56647511112877, 126.9496922384648 37.56845618588184, 126.9536674404707 37.56934444310723, 126.9564122805703 37.56677702966572, 126.9589364470886 37.56554026072097, 126.962543247685 37.56589506505379, 126.962580149133 37.5659715220914, 126.962742230296 37.56616604925539, 126.9629545987368 37.56624585627303, 126.9634090662682 37.56633921113185, 126.9655142790289 37.56666762119831, 126.9658121875202 37.56666901462727)))"
203,서울특별시,서대문구,북아현동,11410555,17607,8383,9224,"MULTIPOLYGON (((126.9620679010407 37.5592609165609, 126.9614834863961 37.55885377187588, 126.9587084229293 37.55665982191486, 126.9586847683168 37.55684337204226, 126.95848525886 37.55723682283254, 126.9570693144166 37.55747914787436, 126.9568396549737 37.55747537489984, 126.9562066835198 37.55746483494933, 126.9552966108147 37.5574422027591, 126.9549844498567 37.55743443562915, 126.9543158000097 37.55729983786602, 126.9532054250295 37.55721808617319, 126.9520101818502 37.5571302967514, 126.9519528966659 37.55712665080522, 126.9488469515568 37.5569707947589, 126.9498647705398 37.5598097397557, 126.9506837895054 37.5602563136864, 126.952529302703 37.56093976926214, 126.9534307376993 37.56115125561123, 126.9554686476701 37.56146375032623, 126.9580522947985 37.56185983749907, 126.9581929693813 37.56188076346466, 126.9592269366924 37.56197000525246, 126.9592887055219 37.56188180294935, 126.9620679010407 37.5592609165609)))"
204,서울특별시,서대문구,신촌동,11410585,24810,9749,15061,"MULTIPOLYGON (((126.9496922384648 37.56845618588184, 126.9500011058816 37.56647511112877, 126.9496803002302 37.56613067300717, 126.9492154277333 37.56515617738945, 126.9495112900011 37.56053365097196, 126.9495954779298 37.56019895885193, 126.9498647705398 37.5598097397557, 126.9488469515568 37.5569707947589, 126.9468122045961 37.5568494513366, 126.9468061483902 37.55690934631656, 126.9468013129129 37.55695711127851, 126.9446851536055 37.55683899477331, 126.9410476803245 37.55644340345586, 126.9402459016724 37.55618953529649, 126.9368665245201 37.55510319990802, 126.9367340777715 37.55511480661422, 126.9364401355039 37.55519868939823, 126.9351076372007 37.55566716019369, 126.9299991144911 37.55755900593189, 126.9271163795182 37.55862807938012, 126.927008649521 37.5586723399723, 126.926855641232 37.55873589931882, 126.9266253047208 37.55883159450014, 126.9264943886857 37.5592005095706, 126.9266775364002 37.56058376609457, 126.9271428752853 37.56175108622682, 126.9271989081632 37.56182912348396, 126.9281336581503 37.56118916846922, 126.9283370060472 37.56106396486805, 126.928413180191 37.56102448518821, 126.9284776273399 37.56099139781928, 126.9295658741395 37.56092344091359, 126.9308211834142 37.56096051472797, 126.9311745436171 37.56108781036915, 126.9314234916629 37.56123653551024, 126.9330624872334 37.56312355012489, 126.9336453571845 37.56460026387147, 126.9344743910458 37.56623344665743, 126.9372277570309 37.5681597080466, 126.938881182079 37.56917370471975, 126.939310629297 37.56940588552276, 126.9413499444607 37.57009802484061, 126.9426519471155 37.57032162844988, 126.9433645838226 37.57090185148729, 126.9434607909261 37.5710025796897, 126.9435098374495 37.57106928508053, 126.9440423028465 37.57218044789825, 126.9440296655546 37.57264345417108, 126.9440142793951 37.57280900376879, 126.9439670806822 37.57296877011873, 126.9439166837698 37.57308345415493, 126.9437791551922 37.57320899446187, 126.9437450071581 37.57323249385198, 126.9437023350546 37.57324185603611, 126.9435319083981 37.57342978530566, 126.9434896757981 37.57349268032896, 126.9434390533565 37.57401869158529, 126.9434335746945 37.57418528826621, 126.9434882630457 37.57453927865817, 126.9435304104977 37.57467814014451, 126.9439311453857 37.57532674296527, 126.9447370863025 37.57659805177294, 126.9456322881007 37.57671718057887, 126.9465723558334 37.57680045919222, 126.9467513512501 37.57681256593307, 126.9475242583264 37.57612220401468, 126.9489529316726 37.57571533601866, 126.9490390316985 37.5756526438039, 126.9490554567076 37.5755936824108, 126.9490753832933 37.57552211853606, 126.949047099628 37.57465444255561, 126.9487928989206 37.57399640107598, 126.9485766413221 37.57385568269773, 126.9485379249885 37.57382620814369, 126.947893656206 37.57327788323353, 126.9478616627565 37.57324900323911, 126.947838875766 37.57322016629827, 126.9478067351287 37.57316368192099, 126.9477182262103 37.57297623886139, 126.9476715574765 37.57279006860558, 126.9489411605683 37.56943628807204, 126.9496922384648 37.56845618588184)))"
205,서울특별시,서대문구,연희동,11410615,41358,19764,21594,"MULTIPOLYGON (((126.9467513512501 37.57681256593307, 126.9465723558334 37.57680045919222, 126.9456322881007 37.57671718057887, 126.9447370863025 37.57659805177294, 126.9439311453857 37.57532674296527, 126.9435304104977 37.57467814014451, 126.9434882630457 37.57453927865817, 126.9434335746945 37.57418528826621, 126.9434390533565 37.57401869158529, 126.9434896757981 37.57349268032896, 126.9435319083981 37.57342978530566, 126.9437023350546 37.57324185603611, 126.9437450071581 37.57323249385198, 126.9437791551922 37.57320899446187, 126.9439166837698 37.57308345415493, 126.9439670806822 37.57296877011873, 126.9440142793951 37.57280900376879, 126.9440296655546 37.57264345417108, 126.9440423028465 37.57218044789825, 126.9435098374495 37.57106928508053, 126.9434607909261 37.5710025796897, 126.9433645838226 37.57090185148729, 126.9426519471155 37.57032162844988, 126.9413499444607 37.57009802484061, 126.939310629297 37.56940588552276, 126.938881182079 37.56917370471975, 126.9372277570309 37.5681597080466, 126.9344743910458 37.56623344665743, 126.9336453571845 37.56460026387147, 126.9330624872334 37.56312355012489, 126.9314234916629 37.56123653551024, 126.9311745436171 37.56108781036915, 126.9308211834142 37.56096051472797, 126.9295658741395 37.56092344091359, 126.9284776273399 37.56099139781928, 126.928413180191 37.56102448518821, 126.9283370060472 37.56106396486805, 126.9281336581503 37.56118916846922, 126.9271989081632 37.56182912348396, 126.9274838378449 37.56223158085356, 126.9281158286508 37.56315284898634, 126.9281453881799 37.5631959538945, 126.9282466988367 37.56334393261646, 126.9269552252732 37.56441772599437, 126.9268230084464 37.5645222972681, 126.9263040204148 37.56491575984872, 126.9261362178161 37.56502709415746, 126.9259569854622 37.56514339764689, 126.9258212349465 37.56521822513922, 126.9256862061452 37.56529192930332, 126.9251314665074 37.56555625279618, 126.9247395122136 37.56572559908883, 126.9177418017608 37.56744328204122, 126.9168544015975 37.56788732253502, 126.9218948872328 37.57190618764044, 126.9273061167108 37.57593673721672, 126.9278270140534 37.57620746239819, 126.9280899754111 37.57634393819279, 126.9299244272257 37.57729584200057, 126.9304116092619 37.5775483165117, 126.9304539136457 37.57756992753371, 126.9321024395195 37.57840597992374, 126.9332616670297 37.57889714982642, 126.9333124922721 37.57891542069656, 126.9343686140331 37.5792844033868, 126.9352362600076 37.57958712766527, 126.9354939331728 37.57967736783478, 126.9366257311764 37.58015147247001, 126.9370470710063 37.58041036542142, 126.9373896461105 37.58064723573001, 126.9374959735545 37.5807724928503, 126.9375941604428 37.58089068511891, 126.937705853039 37.581098526125, 126.9378248297093 37.58137400243622, 126.9379022572466 37.58161882439316, 126.9378070725512 37.58185275631207, 126.9375713761638 37.58222569081676, 126.9374826550975 37.58235145604881, 126.9371939017673 37.58254310851469, 126.9408425784141 37.58390646283884, 126.9418707414623 37.58082873669133, 126.9447101771981 37.57745982721375, 126.9451311179857 37.57720042587319, 126.9459066127002 37.57694942893294, 126.9467513512501 37.57681256593307)))"
206,서울특별시,마포구,용강동,11440590,22403,10641,11762,"MULTIPOLYGON (((126.9445281888074 37.54514799989514, 126.9447600816805 37.54498906868186, 126.9448041713113 37.54495885547149, 126.9449534778755 37.54485738049411, 126.9450494920919 37.54479213246241, 126.9455178404302 37.5444947017651, 126.9478051339241 37.54336059788319, 126.9492325648683 37.54331097248807, 126.949681604116 37.54381892668303, 126.9506424895186 37.54342232220395, 126.9506971240766 37.54339777213969, 126.9497728624981 37.54237308116659, 126.9491655502303 37.54184146049104, 126.9437494645691 37.53798195499444, 126.942887625212 37.53743482890265, 126.9417708676003 37.53673213556684, 126.9406315026389 37.53602819788348, 126.9370875824056 37.53430558366682, 126.9340062933555 37.5363358075863, 126.9346944792319 37.53766291615592, 126.936633058136 37.54139813314953, 126.9370610038947 37.54216181393832, 126.9387677072955 37.5442881374525, 126.9407314087531 37.54661389054507, 126.9445281888074 37.54514799989514)))"
207,서울특별시,마포구,대흥동,11440600,13776,6285,7491,"MULTIPOLYGON (((126.9468122045961 37.5568494513366, 126.94650440813 37.55673930814484, 126.9465563516502 37.55387833282037, 126.9466667604602 37.55305783262048, 126.9452677135306 37.54952411067782, 126.9451715798625 37.54953136551701, 126.945070904008 37.54953895946982, 126.9450342295315 37.54952301350975, 126.9449355015602 37.54947860871641, 126.9449041008802 37.54944305614564, 126.9448435899881 37.54937452157651, 126.9446917480117 37.54914509047187, 126.9437485737233 37.54743372362577, 126.9437202225587 37.54706386776387, 126.9437392963403 37.54696835880313, 126.9437454337984 37.5469422215708, 126.9437699825819 37.54683780783443, 126.9445281888074 37.54514799989514, 126.9407314087531 37.54661389054507, 126.9398660027862 37.54738494797472, 126.9399052295836 37.54762624740258, 126.9374613379911 37.55064878916115, 126.9370370860204 37.55103378326073, 126.9366628006901 37.55126691181142, 126.9364936081652 37.55137201278955, 126.9360956911077 37.55151663699642, 126.9360040446486 37.55154994481377, 126.9357353055894 37.55164728716528, 126.9353654859856 37.5517812432236, 126.9346118685731 37.55225647771094, 126.9340559743738 37.55260754011282, 126.9337180816022 37.55310964510148, 126.9340793160356 37.5534244789128, 126.9368665245201 37.55510319990802, 126.9402459016724 37.55618953529649, 126.9410476803245 37.55644340345586, 126.9446851536055 37.55683899477331, 126.9468013129129 37.55695711127851, 126.9468061483902 37.55690934631656, 126.9468122045961 37.5568494513366)))"
208,서울특별시,마포구,염리동,11440610,13533,6339,7194,"MULTIPOLYGON (((126.949681604116 37.54381892668303, 126.9492325648683 37.54331097248807, 126.9478051339241 37.54336059788319, 126.9455178404302 37.5444947017651, 126.9450494920919 37.54479213246241, 126.9449534778755 37.54485738049411, 126.9448041713113 37.54495885547149, 126.9447600816805 37.54498906868186, 126.9445281888074 37.54514799989514, 126.9437699825819 37.54683780783443, 126.9437454337984 37.5469422215708, 126.9437392963403 37.54696835880313, 126.9437202225587 37.54706386776387, 126.9437485737233 37.54743372362577, 126.9446917480117 37.54914509047187, 126.9448435899881 37.54937452157651, 126.9449041008802 37.54944305614564, 126.9449355015602 37.54947860871641, 126.9450342295315 37.54952301350975, 126.945070904008 37.54953895946982, 126.9451715798625 37.54953136551701, 126.9452677135306 37.54952411067782, 126.9466667604602 37.55305783262048, 126.9465563516502 37.55387833282037, 126.94650440813 37.55673930814484, 126.9468122045961 37.5568494513366, 126.9488469515568 37.5569707947589, 126.9487627092158 37.55542740855991, 126.9496261341447 37.55502091425022, 126.9504065288767 37.55397488873458, 126.9506480878803 37.55297439022646, 126.95060871916 37.55255395361905, 126.9506029073966 37.55249218424722, 126.950587062689 37.55232400913784, 126.9499770007564 37.54762514721393, 126.9484843836123 37.54595293967385, 126.9480373547546 37.54554863749475, 126.9477691380782 37.54536935349683, 126.9478792269796 37.5446432089276, 126.949681604116 37.54381892668303)))"
209,서울특별시,마포구,신수동,11440630,22514,10963,11551,"MULTIPOLYGON (((126.9407314087531 37.54661389054507, 126.9387677072955 37.5442881374525, 126.9370610038947 37.54216181393832, 126.936633058136 37.54139813314953, 126.9346944792319 37.53766291615592, 126.9340062933555 37.5363358075863, 126.9312332668581 37.53669424662898, 126.9296652962672 37.53689705915932, 126.9292299623807 37.53695385900097, 126.9288907524668 37.53703161884063, 126.9286283053523 37.53709178525238, 126.9279153706955 37.53725620986841, 126.9256461421733 37.53778037073113, 126.9254654174898 37.53782230476658, 126.9279024968538 37.54141082452227, 126.9313831880366 37.54508539992953, 126.9314479257129 37.54513190575493, 126.9319038960009 37.54546083909475, 126.9319205348435 37.54550598655517, 126.9325803422118 37.54733269437436, 126.9326263298927 37.54759938174731, 126.9328977417879 37.54931775313242, 126.9329606112453 37.54998505230067, 126.9329608658797 37.55004244592764, 126.9329598532273 37.551482131783, 126.9337180816022 37.55310964510148, 126.9340559743738 37.55260754011282, 126.9346118685731 37.55225647771094, 126.9353654859856 37.5517812432236, 126.9357353055894 37.55164728716528, 126.9360040446486 37.55154994481377, 126.9360956911077 37.55151663699642, 126.9364936081652 37.55137201278955, 126.9366628006901 37.55126691181142, 126.9370370860204 37.55103378326073, 126.9374613379911 37.55064878916115, 126.9399052295836 37.54762624740258, 126.9398660027862 37.54738494797472, 126.9407314087531 37.54661389054507)))"
210,서울특별시,마포구,서교동,11440660,26104,11903,14201,"MULTIPOLYGON (((126.9135347792953 37.54948323708437, 126.9116582359267 37.55421956099342, 126.9087975895597 37.55741869164588, 126.9090892659909 37.55765668378945, 126.9102349677249 37.55793401479872, 126.9106517078131 37.55803073704563, 126.9120106619934 37.55826172150362, 126.9131147116165 37.55824355441472, 126.915133394274 37.5582308893665, 126.9153626107482 37.55823104756686, 126.9154167454324 37.55823131561912, 126.9157569662874 37.558249899912, 126.9161653917702 37.55830332402729, 126.9161991595708 37.55830846643247, 126.9162447223476 37.55831540674399, 126.9164348080354 37.55837370987715, 126.9166523623086 37.55845617379443, 126.9170081760439 37.5585985961939, 126.9176020782441 37.55883815488033, 126.9178252948446 37.55859163990269, 126.9187799318839 37.55754043390255, 126.9216136540982 37.55946594204042, 126.9262524523884 37.56122060191414, 126.9271428752853 37.56175108622682, 126.9266775364002 37.56058376609457, 126.9264943886857 37.5592005095706, 126.9266253047208 37.55883159450014, 126.926855641232 37.55873589931882, 126.927008649521 37.5586723399723, 126.9271163795182 37.55862807938012, 126.9299991144911 37.55755900593189, 126.9351076372007 37.55566716019369, 126.9364401355039 37.55519868939823, 126.9367340777715 37.55511480661422, 126.9368665245201 37.55510319990802, 126.9340793160356 37.5534244789128, 126.9309449054894 37.55471356454586, 126.9293106705781 37.55415124036514, 126.9255183252951 37.55333137986034, 126.925042726905 37.55317474527072, 126.9242179213387 37.55239327917703, 126.9241135074608 37.55226059645138, 126.924096081736 37.55222706247578, 126.9240685255545 37.55212117754472, 126.9240944199308 37.55189130265663, 126.9241018923207 37.55185299580587, 126.9241069367143 37.55182714273984, 126.9242144816767 37.55155275641901, 126.924246112768 37.55111907432779, 126.9242355356329 37.55092980296554, 126.9238719363962 37.55064410505157, 126.9218517485528 37.54909968700363, 126.9211515500604 37.54869853698207, 126.9202954202461 37.54831353113426, 126.9193802030126 37.54838000183035, 126.9187363244711 37.54842809803108, 126.9183396302652 37.54850697192996, 126.918058374963 37.54856393389552, 126.9169990542469 37.54877950853584, 126.9165490289902 37.54887305379432, 126.9150855678079 37.54917790465854, 126.9150385999819 37.54921704732364, 126.9148046700218 37.54941381043086, 126.9145861924512 37.54959760268188, 126.9143877075036 37.54976505221052, 126.9156200235459 37.5507012295055, 126.9155599273265 37.55075572402312, 126.9154091120298 37.5508821538368, 126.9152586100121 37.55077352099799, 126.9144015291295 37.55015486582036, 126.9135347792953 37.54948323708437)))"
211,서울특별시,마포구,합정동,11440680,19175,8928,10247,"MULTIPOLYGON (((126.9135347792953 37.54948323708437, 126.9144015291295 37.55015486582036, 126.9152586100121 37.55077352099799, 126.9154091120298 37.5508821538368, 126.9155599273265 37.55075572402312, 126.9156200235459 37.5507012295055, 126.9143877075036 37.54976505221052, 126.9145861924512 37.54959760268188, 126.9148046700218 37.54941381043086, 126.9150385999819 37.54921704732364, 126.9150855678079 37.54917790465854, 126.9165490289902 37.54887305379432, 126.9169990542469 37.54877950853584, 126.918058374963 37.54856393389552, 126.9183396302652 37.54850697192996, 126.9187363244711 37.54842809803108, 126.9193802030126 37.54838000183035, 126.9202954202461 37.54831353113426, 126.9196892258002 37.54730779007571, 126.9176468580008 37.54463537955714, 126.9166959083577 37.5434623137176, 126.9160567974384 37.5424958392827, 126.91451019651 37.54015593272531, 126.9077129252561 37.54166765894863, 126.9040458723185 37.54284145707141, 126.900866487906 37.54407709506619, 126.9007181519882 37.54413492988729, 126.8992762718458 37.54492867538313, 126.8989237887093 37.54512292456586, 126.8984062718841 37.54540812513917, 126.8967563522268 37.54631737308835, 126.9010640476663 37.54998079137043, 126.9028352563106 37.55146346364422, 126.9098433497985 37.5536641841241, 126.9116582359267 37.55421956099342, 126.9135347792953 37.54948323708437)))"
212,서울특별시,마포구,망원1동,11440690,21995,10357,11638,"MULTIPOLYGON (((126.9087975895597 37.55741869164588, 126.9116582359267 37.55421956099342, 126.9098433497985 37.5536641841241, 126.9028352563106 37.55146346364422, 126.9010640476663 37.54998079137043, 126.8967563522268 37.54631737308835, 126.8897544007029 37.55017183813918, 126.8929222242833 37.5528584441836, 126.8952839775353 37.55456031700076, 126.8968991970073 37.55571017749935, 126.8999392280682 37.55633331712638, 126.9081889781228 37.55804775152233, 126.9087975895597 37.55741869164588)))"
213,서울특별시,마포구,망원2동,11440700,19270,9169,10101,"MULTIPOLYGON (((126.9043048704066 37.56239755941199, 126.9081889781228 37.55804775152233, 126.8999392280682 37.55633331712638, 126.8968991970073 37.55571017749935, 126.8952839775353 37.55456031700076, 126.8929222242833 37.5528584441836, 126.8897544007029 37.55017183813918, 126.8831662843492 37.55446522843518, 126.8943215126057 37.5598904888211, 126.9000020946687 37.56223707536697, 126.9019602227186 37.56303343439581, 126.9023553995021 37.56317401721145, 126.9033372881706 37.56330283738475, 126.9038100821801 37.56278710340528, 126.9043048704066 37.56239755941199)))"
214,서울특별시,마포구,연남동,11440710,17051,7937,9114,"MULTIPOLYGON (((126.9271989081632 37.56182912348396, 126.9271428752853 37.56175108622682, 126.9262524523884 37.56122060191414, 126.9216136540982 37.55946594204042, 126.9187799318839 37.55754043390255, 126.9178252948446 37.55859163990269, 126.9176020782441 37.55883815488033, 126.9179142297923 37.55929034181531, 126.9179465423221 37.55940985729385, 126.9181507145677 37.56053424655495, 126.9181147706668 37.56098360727223, 126.9178581893507 37.56184010846962, 126.9175804548784 37.56250470921106, 126.9175513282173 37.56254804189668, 126.9173858627871 37.56253145102353, 126.9171507890728 37.56336077193869, 126.9170947163665 37.56357097264647, 126.9169492311296 37.5644378932306, 126.9168169622437 37.56556407393158, 126.9166629233119 37.56693883660667, 126.9177418017608 37.56744328204122, 126.9247395122136 37.56572559908883, 126.9251314665074 37.56555625279618, 126.9256862061452 37.56529192930332, 126.9258212349465 37.56521822513922, 126.9259569854622 37.56514339764689, 126.9261362178161 37.56502709415746, 126.9263040204148 37.56491575984872, 126.9268230084464 37.5645222972681, 126.9269552252732 37.56441772599437, 126.9282466988367 37.56334393261646, 126.9281453881799 37.5631959538945, 126.9281158286508 37.56315284898634, 126.9274838378449 37.56223158085356, 126.9271989081632 37.56182912348396)))"
215,서울특별시,마포구,성산1동,11440720,20288,9539,10749,"MULTIPOLYGON (((126.9176020782441 37.55883815488033, 126.9170081760439 37.5585985961939, 126.9166523623086 37.55845617379443, 126.9164348080354 37.55837370987715, 126.9162447223476 37.55831540674399, 126.9161991595708 37.55830846643247, 126.9161653917702 37.55830332402729, 126.9157569662874 37.558249899912, 126.9154167454324 37.55823131561912, 126.9153626107482 37.55823104756686, 126.915133394274 37.5582308893665, 126.9131147116165 37.55824355441472, 126.9120106619934 37.55826172150362, 126.9106517078131 37.55803073704563, 126.9102349677249 37.55793401479872, 126.9090892659909 37.55765668378945, 126.9087975895597 37.55741869164588, 126.9081889781228 37.55804775152233, 126.9043048704066 37.56239755941199, 126.9035840924174 37.56337254155295, 126.9154373956093 37.56681446783543, 126.9166629233119 37.56693883660667, 126.9168169622437 37.56556407393158, 126.9169492311296 37.5644378932306, 126.9170947163665 37.56357097264647, 126.9171507890728 37.56336077193869, 126.9173858627871 37.56253145102353, 126.9175513282173 37.56254804189668, 126.9175804548784 37.56250470921106, 126.9178581893507 37.56184010846962, 126.9181147706668 37.56098360727223, 126.9181507145677 37.56053424655495, 126.9179465423221 37.55940985729385, 126.9179142297923 37.55929034181531, 126.9176020782441 37.55883815488033)))"
216,서울특별시,마포구,성산2동,11440730,41623,19204,22419,"MULTIPOLYGON (((126.9118051132751 37.57027898846455, 126.9168544015975 37.56788732253502, 126.9177418017608 37.56744328204122, 126.9166629233119 37.56693883660667, 126.9154373956093 37.56681446783543, 126.9035840924174 37.56337254155295, 126.9043048704066 37.56239755941199, 126.9038100821801 37.56278710340528, 126.9033372881706 37.56330283738475, 126.9023553995021 37.56317401721145, 126.9019602227186 37.56303343439581, 126.9000020946687 37.56223707536697, 126.8943215126057 37.5598904888211, 126.893644012782 37.56141145123078, 126.8943844962828 37.56302504531712, 126.894568192711 37.56351177852243, 126.8947760316445 37.56406379062059, 126.8949370766664 37.56462682929417, 126.8951008568384 37.5652011485137, 126.8948582967179 37.56649108009984, 126.8936892866868 37.56717460978118, 126.8928008264197 37.56762978260372, 126.8919706855073 37.5683855675492, 126.891163375328 37.56970452412119, 126.8912173568889 37.57089795405108, 126.892054710435 37.57271622111926, 126.892144193127 37.57285300995186, 126.8923077116474 37.57293722599432, 126.8935373269602 37.57325901923465, 126.8939294178652 37.57326103290661, 126.894015965573 37.57321618746452, 126.8940740908198 37.57313896767413, 126.8943122093936 37.57283823993331, 126.894405164586 37.57272154230715, 126.8945685103418 37.5726525261146, 126.8947302036664 37.57266451388857, 126.8947807137234 37.57266826105127, 126.8965717703672 37.57288248533965, 126.8991012994255 37.57325151513029, 126.9002940562973 37.57383884918893, 126.9016074451945 37.57546229817317, 126.9047785603159 37.57339284870578, 126.9118051132751 37.57027898846455)))"
217,서울특별시,마포구,상암동,11440740,32976,15745,17231,"MULTIPOLYGON (((126.8982002529728 37.57826168402391, 126.8985945773639 37.57799296302955, 126.9016384701362 37.5759187600103, 126.9028198155846 37.57714710835636, 126.9031269616782 37.57689188651241, 126.9016074451945 37.57546229817317, 126.9002940562973 37.57383884918893, 126.8991012994255 37.57325151513029, 126.8965717703672 37.57288248533965, 126.8947807137234 37.57266826105127, 126.8947302036664 37.57266451388857, 126.8945685103418 37.5726525261146, 126.894405164586 37.57272154230715, 126.8943122093936 37.57283823993331, 126.8940740908198 37.57313896767413, 126.894015965573 37.57321618746452, 126.8939294178652 37.57326103290661, 126.8935373269602 37.57325901923465, 126.8923077116474 37.57293722599432, 126.892144193127 37.57285300995186, 126.892054710435 37.57271622111926, 126.8912173568889 37.57089795405108, 126.891163375328 37.56970452412119, 126.8919706855073 37.5683855675492, 126.8928008264197 37.56762978260372, 126.8936892866868 37.56717460978118, 126.8948582967179 37.56649108009984, 126.8951008568384 37.5652011485137, 126.8949370766664 37.56462682929417, 126.8947760316445 37.56406379062059, 126.894568192711 37.56351177852243, 126.8943844962828 37.56302504531712, 126.893644012782 37.56141145123078, 126.8943215126057 37.5598904888211, 126.8831662843492 37.55446522843518, 126.8761341968334 37.55912658761509, 126.8692583211439 37.5638862757829, 126.8662839125682 37.56589160853773, 126.8642204360812 37.56686861025829, 126.8605076214259 37.56862532577344, 126.8603306129429 37.56870889550703, 126.8584034858136 37.5696211589387, 126.8574143359696 37.57107257166085, 126.85775240042 37.57464240610413, 126.8578452280807 37.57562105304849, 126.8617233587331 37.57585615430218, 126.8649540818197 37.57583670668176, 126.8666445723578 37.57645388650749, 126.8679906708789 37.57739286210846, 126.8733451257962 37.57884665357865, 126.8762592572779 37.57896289567578, 126.8770765689666 37.57890294324922, 126.8774413573245 37.57940415282648, 126.8775222047042 37.57951523499246, 126.8776316670701 37.57974848066657, 126.8774695841369 37.58030804715512, 126.8766344280434 37.58155907811828, 126.8766718219819 37.58412133510443, 126.8776320644497 37.58620286290891, 126.8802864898998 37.5896407938631, 126.8803672602051 37.58970793415009, 126.880491093297 37.58981086906532, 126.8822410175408 37.59093660473638, 126.8832548932839 37.59006307044694, 126.8869786781206 37.58686356073997, 126.8874406483675 37.58646711613211, 126.8894079244553 37.58481771545058, 126.8896534292146 37.58463747412624, 126.8899199553733 37.58444180002028, 126.8899697991227 37.58440600400859, 126.890225144344 37.58423843470268, 126.8921768677375 37.58293919097798, 126.8952926832612 37.58146303404953, 126.8962298368553 37.58085411699324, 126.8966632485242 37.58048853079705, 126.897908384158 37.57916941155027, 126.8982002529728 37.57826168402391)))"
218,서울특별시,마포구,도화동,11440585,22663,10772,11891,"MULTIPOLYGON (((126.956400908531 37.54058497383463, 126.953843087381 37.53848988563785, 126.9530081251642 37.53784721518655, 126.9530097583764 37.53780663495228, 126.9530135509406 37.53767483005122, 126.952994745193 37.53757012322018, 126.9529854531841 37.53751886545702, 126.9529684675836 37.53742578275144, 126.952826098804 37.53728412764071, 126.9522346649203 37.53680367004696, 126.9513102441408 37.53629462225033, 126.9511269139266 37.53621264875299, 126.9507583358477 37.53611741995191, 126.9494217055138 37.53587008443885, 126.9478106062036 37.53562256839294, 126.9463955384538 37.5357421699634, 126.9461861413993 37.5356532776357, 126.9460519636596 37.53559510609899, 126.9454327557922 37.53519236537115, 126.9450815156394 37.53493489864969, 126.945003636551 37.534466957167, 126.9435704355748 37.52941828315847, 126.9370875824056 37.53430558366682, 126.9406315026389 37.53602819788348, 126.9417708676003 37.53673213556684, 126.942887625212 37.53743482890265, 126.9437494645691 37.53798195499444, 126.9491655502303 37.54184146049104, 126.9497728624981 37.54237308116659, 126.9506971240766 37.54339777213969, 126.956400908531 37.54058497383463)))"
219,서울특별시,마포구,서강동,11440655,26240,12338,13902,"MULTIPOLYGON (((126.9340793160356 37.5534244789128, 126.9337180816022 37.55310964510148, 126.9329598532273 37.551482131783, 126.9329608658797 37.55004244592764, 126.9329606112453 37.54998505230067, 126.9328977417879 37.54931775313242, 126.9326263298927 37.54759938174731, 126.9325803422118 37.54733269437436, 126.9319205348435 37.54550598655517, 126.9319038960009 37.54546083909475, 126.9314479257129 37.54513190575493, 126.9313831880366 37.54508539992953, 126.9279024968538 37.54141082452227, 126.9254654174898 37.53782230476658, 126.91451019651 37.54015593272531, 126.9160567974384 37.5424958392827, 126.9166959083577 37.5434623137176, 126.9176468580008 37.54463537955714, 126.9196892258002 37.54730779007571, 126.9202954202461 37.54831353113426, 126.9211515500604 37.54869853698207, 126.9218517485528 37.54909968700363, 126.9238719363962 37.55064410505157, 126.9242355356329 37.55092980296554, 126.924246112768 37.55111907432779, 126.9242144816767 37.55155275641901, 126.9241069367143 37.55182714273984, 126.9241018923207 37.55185299580587, 126.9240944199308 37.55189130265663, 126.9240685255545 37.55212117754472, 126.924096081736 37.55222706247578, 126.9241135074608 37.55226059645138, 126.9242179213387 37.55239327917703, 126.925042726905 37.55317474527072, 126.9255183252951 37.55333137986034, 126.9293106705781 37.55415124036514, 126.9309449054894 37.55471356454586, 126.9340793160356 37.5534244789128)))"
220,서울특별시,마포구,공덕동,11440565,40603,19306,21297,"MULTIPOLYGON (((126.9623868743941 37.55150399398249, 126.9631996202727 37.54867748111055, 126.9629344528892 37.54878005031158, 126.9616204984659 37.54769695633127, 126.9586293379188 37.54558188748002, 126.9578032919165 37.54289883621519, 126.9577002539413 37.54208264069798, 126.9565075360991 37.5407048529434, 126.956400908531 37.54058497383463, 126.9506971240766 37.54339777213969, 126.9506424895186 37.54342232220395, 126.9504656995462 37.54354155028949, 126.9516785403981 37.54514460537914, 126.9520571181234 37.54564452933742, 126.9522102482157 37.54558559216117, 126.9535773890345 37.54746271683133, 126.9539896828331 37.54807647310309, 126.9577678217168 37.55513109989602, 126.9587084229293 37.55665982191486, 126.9614834863961 37.55885377187588, 126.9630366208267 37.5581825818219, 126.9632159136027 37.55715025898734, 126.9630980674387 37.55642298000916, 126.9629271112777 37.55622661812477, 126.9620501845675 37.55532645358582, 126.962020870108 37.55533783023146, 126.9619841986044 37.55535206667223, 126.961838039219 37.55540660812221, 126.9617027044694 37.55534292838134, 126.9616618402714 37.55334171879928, 126.961707249935 37.55296638811462, 126.9620685757563 37.55207943160345, 126.9621362215918 37.55192200380381, 126.9623868743941 37.55150399398249)))"
221,서울특별시,마포구,아현동,11440555,25391,11942,13449,"MULTIPOLYGON (((126.9587084229293 37.55665982191486, 126.9577678217168 37.55513109989602, 126.9539896828331 37.54807647310309, 126.9535773890345 37.54746271683133, 126.9522102482157 37.54558559216117, 126.9520571181234 37.54564452933742, 126.9516785403981 37.54514460537914, 126.9504656995462 37.54354155028949, 126.9506424895186 37.54342232220395, 126.949681604116 37.54381892668303, 126.9478792269796 37.5446432089276, 126.9477691380782 37.54536935349683, 126.9480373547546 37.54554863749475, 126.9484843836123 37.54595293967385, 126.9499770007564 37.54762514721393, 126.950587062689 37.55232400913784, 126.9506029073966 37.55249218424722, 126.95060871916 37.55255395361905, 126.9506480878803 37.55297439022646, 126.9504065288767 37.55397488873458, 126.9496261341447 37.55502091425022, 126.9487627092158 37.55542740855991, 126.9488469515568 37.5569707947589, 126.9519528966659 37.55712665080522, 126.9520101818502 37.5571302967514, 126.9532054250295 37.55721808617319, 126.9543158000097 37.55729983786602, 126.9549844498567 37.55743443562915, 126.9552966108147 37.5574422027591, 126.9562066835198 37.55746483494933, 126.9568396549737 37.55747537489984, 126.9570693144166 37.55747914787436, 126.95848525886 37.55723682283254, 126.9586847683168 37.55684337204226, 126.9587084229293 37.55665982191486)))"
222,서울특별시,양천구,목1동,11470510,32111,15467,16644,"MULTIPOLYGON (((126.8884819009021 37.53072097060306, 126.887607780364 37.52947935348696, 126.8870539851164 37.5287801894297, 126.8869559648205 37.52865687186527, 126.8865860313941 37.5283090574286, 126.8863143719969 37.52805526839077, 126.8860296686521 37.52792534638895, 126.8853460962087 37.52761420531862, 126.8847564854362 37.52740382490448, 126.8817318907785 37.52632158032202, 126.8813723376457 37.52599945718262, 126.880509929507 37.52522627515442, 126.8804883168931 37.52514734782051, 126.8802765808055 37.5243631348928, 126.8798227580196 37.52219530320006, 126.8744538328839 37.52266589684996, 126.8711583668483 37.52312966240473, 126.8685903383835 37.52396322341522, 126.8653968185938 37.52256707561142, 126.864415365744 37.5258347935631, 126.8643177413933 37.5262111434615, 126.8642131579701 37.52715755936369, 126.8641740612602 37.52751338135064, 126.8640497326266 37.52924442740505, 126.8640110353512 37.52979969525946, 126.8671871035582 37.53022008927621, 126.8703669403103 37.53062785597789, 126.873933642554 37.53110556837687, 126.875046465155 37.531261311763, 126.8796148222877 37.53175973357148, 126.8806023620007 37.53184040522279, 126.8808334785643 37.53185513201099, 126.8814801330651 37.53189457999601, 126.8825261741708 37.53187301360647, 126.882591090727 37.53186803506275, 126.8829522881839 37.53184031361199, 126.8837365723034 37.53177906120537, 126.8850654331224 37.53155839784986, 126.8864270089108 37.53131535577163, 126.8865092048257 37.53129203677788, 126.8884819009021 37.53072097060306)))"
223,서울특별시,양천구,목2동,11470520,31501,15393,16108,"MULTIPOLYGON (((126.8851569446344 37.54358960812174, 126.8834894186106 37.54401468654915, 126.8818877045188 37.54357817344732, 126.8774909563707 37.54149775311591, 126.8743730054951 37.53914002714675, 126.8726691570017 37.5375727845262, 126.8694460997191 37.53933352439084, 126.8684672998337 37.53979136762891, 126.8679307446941 37.54025493633177, 126.8661626994313 37.54410997972625, 126.8662662802591 37.54449473423405, 126.8663296449142 37.54469444020702, 126.8668579638068 37.54557053738056, 126.8685348469798 37.54722444521772, 126.8700487159159 37.54699257001761, 126.8707019494657 37.54765176034911, 126.8711631969141 37.54749084797478, 126.871766967011 37.54729351257811, 126.8720624169152 37.54721015940467, 126.8724215583822 37.54710883770095, 126.8730038932614 37.54701954346767, 126.8734706092402 37.54696568674522, 126.874018558187 37.54692690572119, 126.8746175492268 37.54694244619375, 126.874891454919 37.54694955703867, 126.8749463805087 37.54695238960052, 126.8750130968535 37.54695583436721, 126.8768461715786 37.54705565724711, 126.8773684323273 37.54711473652327, 126.8777233300041 37.54715491909874, 126.877813230747 37.54716560329386, 126.8778908852848 37.54717721438011, 126.8781353761917 37.54721455609788, 126.878490688872 37.54730793958105, 126.8794040373496 37.5475479686388, 126.8798806733279 37.54766548362601, 126.8807138463221 37.54787031656874, 126.8832474831551 37.54555697857488, 126.8851569446344 37.54358960812174)))"
224,서울특별시,양천구,목3동,11470530,23145,11135,12010,"MULTIPOLYGON (((126.8649828545064 37.55092804368461, 126.8707019494657 37.54765176034911, 126.8700487159159 37.54699257001761, 126.8685348469798 37.54722444521772, 126.8668579638068 37.54557053738056, 126.8663296449142 37.54469444020702, 126.8662662802591 37.54449473423405, 126.8661626994313 37.54410997972625, 126.8679307446941 37.54025493633177, 126.8684672998337 37.53979136762891, 126.8636723578317 37.53928339616603, 126.862939034815 37.54247349040538, 126.8623436567476 37.5436028202059, 126.8623299288978 37.54364205104475, 126.862294562993 37.5437446765309, 126.8621594463982 37.54413687025475, 126.862174458124 37.54447550567989, 126.8621851118674 37.54455769471636, 126.8624250645519 37.54543271595348, 126.862541025977 37.54585374025271, 126.862931847282 37.54701743995786, 126.8642847311346 37.55138951230217, 126.8649828545064 37.55092804368461)))"
225,서울특별시,양천구,목4동,11470540,27053,13283,13770,"MULTIPOLYGON (((126.8726691570017 37.5375727845262, 126.8725363391996 37.53746617060789, 126.8713672962024 37.5364977652283, 126.871116588027 37.53627898038118, 126.8709687754957 37.53614967905472, 126.8708988863938 37.53608853793563, 126.870565313296 37.5357960759872, 126.8702383328396 37.53547773452172, 126.8701513277872 37.53539276920994, 126.8700180238433 37.53517798820264, 126.8699109222014 37.53500368213398, 126.8698721660942 37.53494060637511, 126.8678980891054 37.53161518925779, 126.8671871035582 37.53022008927621, 126.8640110353512 37.52979969525946, 126.8634948363395 37.53559931239673, 126.8636723578317 37.53928339616603, 126.8684672998337 37.53979136762891, 126.8694460997191 37.53933352439084, 126.8726691570017 37.5375727845262)))"
226,서울특별시,양천구,신월1동,11470560,21976,11229,10747,"MULTIPOLYGON (((126.840485322699 37.52653732844918, 126.834894841198 37.52555167632494, 126.8332839058675 37.52836841387676, 126.8330398718761 37.52879358278339, 126.8325065883467 37.52972260059889, 126.8319732740498 37.53050611224511, 126.8315618658333 37.53110881279664, 126.8296451126319 37.53390167279065, 126.8285096372649 37.53591144079167, 126.8351653501694 37.53691235409344, 126.8347266741849 37.53603400665195, 126.840485322699 37.52653732844918)))"
227,서울특별시,양천구,신월2동,11470570,22427,11000,11427,"MULTIPOLYGON (((126.8516123006577 37.52172152317272, 126.8485342897586 37.52252368495845, 126.8479987822565 37.52253425006497, 126.847598207521 37.52248133714392, 126.8472920268123 37.52239063729067, 126.8470202623606 37.52224717273834, 126.8469058199253 37.52215077171815, 126.8468103248343 37.52207024987106, 126.846924644949 37.52194034435039, 126.8475037657064 37.52156115285333, 126.8486632117853 37.52071177402568, 126.8486383535949 37.51991034994398, 126.8486338807838 37.51977399632351, 126.8485486917418 37.51785816159848, 126.8485475025929 37.51783224036172, 126.8485172057946 37.5172495774956, 126.8485050107992 37.51702529880038, 126.8484807234708 37.51698365951524, 126.8469829830611 37.51751714198285, 126.8465807011823 37.517662512947, 126.8457733054051 37.51795436173398, 126.8456768092062 37.51798988112437, 126.8444373984259 37.52004256043025, 126.840485322699 37.52653732844918, 126.8488955583255 37.52789881782952, 126.8516801344629 37.52262887722133, 126.8516123006577 37.52172152317272)))"
228,서울특별시,양천구,신월3동,11470580,16844,8886,7958,"MULTIPOLYGON (((126.8285096372649 37.53591144079167, 126.8296451126319 37.53390167279065, 126.8315618658333 37.53110881279664, 126.8319732740498 37.53050611224511, 126.8325065883467 37.52972260059889, 126.8330398718761 37.52879358278339, 126.8332839058675 37.52836841387676, 126.834894841198 37.52555167632494, 126.8259159115883 37.52407667736358, 126.8281539782071 37.5257985720794, 126.8284606292314 37.52670278937289, 126.8282099036906 37.52879023343128, 126.8281730423761 37.52895677277083, 126.8280943683315 37.52905321988616, 126.8279583664492 37.52915384745783, 126.8279135065179 37.52918626596136, 126.8274209559103 37.52952709997379, 126.8273007157511 37.52960528288959, 126.8272339323665 37.529633335414, 126.8271807170265 37.52965529999561, 126.8270161833281 37.52971721604428, 126.8268135507421 37.52977883266727, 126.8267352011516 37.52979922964249, 126.8265863488594 37.52983330808773, 126.8264343200623 37.52982793434471, 126.8261654214119 37.52975992608964, 126.8260776725965 37.5297639321028, 126.8257821762112 37.52982308629404, 126.8257124785181 37.52983847994015, 126.8256092338107 37.52986153269882, 126.825569487363 37.52988083337411, 126.8254988876227 37.52991657863762, 126.8254408208592 37.52994619869523, 126.8252861977347 37.53003318758643, 126.8251132884964 37.53018431068568, 126.8247364691603 37.53063282949396, 126.8239754587979 37.53179459138665, 126.822577378184 37.53393966820957, 126.8218134265111 37.53479381443789, 126.8218033948278 37.53482481717123, 126.8217738784362 37.53492566227683, 126.8217741014328 37.53507413128376, 126.8219396345678 37.53562152218861, 126.8221998229243 37.53602749436447, 126.8222564614169 37.53617886228832, 126.822256155416 37.53629146102103, 126.8221894003453 37.53806553690702, 126.8221177252597 37.53831717742415, 126.8219599474193 37.53887107606542, 126.8219278913433 37.53898359608691, 126.8218613803666 37.53918476373786, 126.821849870327 37.53921195879411, 126.8221471074897 37.54067925643016, 126.8247831446914 37.54098954932963, 126.8251922087156 37.54058064853804, 126.8252236184947 37.5405494251986, 126.8252811122821 37.54049211907469, 126.8253302197793 37.54041806850647, 126.8253483378517 37.5403846239902, 126.8254100743611 37.54029158841851, 126.825439281107 37.54024856285078, 126.825483760496 37.54018008943331, 126.8255124633801 37.54013518617206, 126.8255470904934 37.5400810148675, 126.8255834972098 37.54002405053523, 126.8256326011171 37.53994831970669, 126.8257033163844 37.53983883253508, 126.8260168545352 37.5393516431876, 126.8260520102946 37.53929776317247, 126.8262008110892 37.53906650261494, 126.8263964039865 37.53876230158423, 126.8270690466842 37.53775437732027, 126.8274318889943 37.53721113087878, 126.8275513192711 37.53706693788241, 126.8275747084723 37.53703871836672, 126.8285096372649 37.53591144079167)))"
229,서울특별시,양천구,신월4동,11470590,19064,9368,9696,"MULTIPOLYGON (((126.8444373984259 37.52004256043025, 126.8394453942922 37.51708655149896, 126.8390605754046 37.5179669304714, 126.8384659114412 37.5193265207209, 126.8380054729215 37.52036837776262, 126.8379194186692 37.52056228006386, 126.8379037158143 37.52059765105849, 126.837833291158 37.52072344493142, 126.8373389073367 37.52160286616289, 126.8372002312041 37.5218488319056, 126.834894841198 37.52555167632494, 126.840485322699 37.52653732844918, 126.8444373984259 37.52004256043025)))"
230,서울특별시,양천구,신월5동,11470600,15631,7735,7896,"MULTIPOLYGON (((126.829919308284 37.54613280657835, 126.8300838260738 37.54171914678337, 126.8304480918408 37.54175189457496, 126.8306921034128 37.54176003800688, 126.8314262438318 37.54178447720044, 126.8331398865925 37.54184148790216, 126.8332786037656 37.54143130322322, 126.8333266955102 37.54128821591202, 126.8334859996087 37.54079562907653, 126.8337786381739 37.53987114976861, 126.8351653501694 37.53691235409344, 126.8285096372649 37.53591144079167, 126.8275747084723 37.53703871836672, 126.8275513192711 37.53706693788241, 126.8274318889943 37.53721113087878, 126.8270690466842 37.53775437732027, 126.8263964039865 37.53876230158423, 126.8262008110892 37.53906650261494, 126.8260520102946 37.53929776317247, 126.8260168545352 37.5393516431876, 126.8257033163844 37.53983883253508, 126.8256326011171 37.53994831970669, 126.8255834972098 37.54002405053523, 126.8255470904934 37.5400810148675, 126.8255124633801 37.54013518617206, 126.825483760496 37.54018008943331, 126.825439281107 37.54024856285078, 126.8254100743611 37.54029158841851, 126.8253483378517 37.5403846239902, 126.8253302197793 37.54041806850647, 126.8252811122821 37.54049211907469, 126.8252236184947 37.5405494251986, 126.8251922087156 37.54058064853804, 126.8247831446914 37.54098954932963, 126.8254095200347 37.54104497470419, 126.8254728287336 37.54106432768259, 126.8256649854365 37.54112308868118, 126.8259431509637 37.54125193314932, 126.8265544837228 37.54166007431613, 126.8268141412518 37.54189662184648, 126.827124357932 37.54246309105373, 126.8274562046906 37.54320545368986, 126.8275125912044 37.54350635499691, 126.8277158907672 37.54426576814488, 126.8280841452093 37.54540919068952, 126.8282337996752 37.54564383630436, 126.8287331435789 37.54625338398301, 126.8288620941734 37.54637949387842, 126.8288931117384 37.5464098020886, 126.8291333824311 37.54651366824061, 126.8293731038718 37.54652855015457, 126.8296793163264 37.54638719161765, 126.8298799386134 37.54618441040766, 126.829919308284 37.54613280657835)))"
231,서울특별시,양천구,신월6동,11470610,6670,3310,3360,"MULTIPOLYGON (((126.8484807234708 37.51698365951524, 126.8485664084475 37.51599446722089, 126.8462240755858 37.51492607138799, 126.8425359996884 37.51314346200965, 126.8422530713399 37.51306752547605, 126.8414478769471 37.51311261298428, 126.8376650003567 37.51367733739046, 126.8361492483939 37.51445188356931, 126.8355598695967 37.51476853922294, 126.8354035296676 37.51485328773841, 126.8352687789409 37.51497317494194, 126.8349288503794 37.51564938545428, 126.8394453942922 37.51708655149896, 126.8444373984259 37.52004256043025, 126.8456768092062 37.51798988112437, 126.8457733054051 37.51795436173398, 126.8465807011823 37.517662512947, 126.8469829830611 37.51751714198285, 126.8484807234708 37.51698365951524)))"
232,서울특별시,양천구,신월7동,11470611,21803,10701,11102,"MULTIPOLYGON (((126.8394453942922 37.51708655149896, 126.8349288503794 37.51564938545428, 126.8343798266179 37.51544169198075, 126.8338526732964 37.51524227110673, 126.832270689928 37.51630938570816, 126.8321789643017 37.51640006641625, 126.8321518397074 37.51642808017466, 126.8315277171701 37.51710056051275, 126.8309134050072 37.51778210738919, 126.8296449875458 37.51851629153796, 126.8284816558689 37.51867528665645, 126.8279491491195 37.51874774656003, 126.825420436224 37.51909171900803, 126.8255752975532 37.52011327477689, 126.8255825237201 37.52049300948507, 126.825589698402 37.52197463982101, 126.8252199105419 37.52298296458513, 126.8252053576118 37.52302702039131, 126.8252315942718 37.5230981513599, 126.82525092855 37.52314896258324, 126.8259159115883 37.52407667736358, 126.834894841198 37.52555167632494, 126.8372002312041 37.5218488319056, 126.8373389073367 37.52160286616289, 126.837833291158 37.52072344493142, 126.8379037158143 37.52059765105849, 126.8379194186692 37.52056228006386, 126.8380054729215 37.52036837776262, 126.8384659114412 37.5193265207209, 126.8390605754046 37.5179669304714, 126.8394453942922 37.51708655149896)))"
233,서울특별시,양천구,신정1동,11470620,21578,10559,11019,"MULTIPOLYGON (((126.8625966664261 37.51687459664348, 126.8592119524395 37.51570030200461, 126.8591570328402 37.51567504115953, 126.8588794664267 37.51554526826983, 126.8587683005342 37.51539594211519, 126.8587690089399 37.51507246059894, 126.8589479950603 37.51472339484337, 126.8584460589884 37.51454016252482, 126.8574891842615 37.51421047526459, 126.8567910039123 37.51397003126517, 126.8562876195844 37.51379945217542, 126.8559378538257 37.51368152911408, 126.8524608887322 37.52124846420771, 126.8527506233255 37.52116484793041, 126.8529168128535 37.52111688746948, 126.8532135842791 37.52115006027179, 126.854122970822 37.52125193188181, 126.8554809844827 37.52141257987643, 126.8561597955505 37.52149289695699, 126.8568672652514 37.52157674626025, 126.8582634442282 37.52174207685863, 126.8593925471692 37.52187552210807, 126.8615610646925 37.52212837522772, 126.8619492101859 37.52217271000647, 126.863242083937 37.5223188468647, 126.8653968185938 37.52256707561142, 126.8660315567504 37.52124322118843, 126.8673297255469 37.51852585416795, 126.8660597564005 37.51807738322443, 126.8652121689269 37.51777876552408, 126.8625966664261 37.51687459664348)))"
234,서울특별시,양천구,신정2동,11470630,20713,10125,10588,"MULTIPOLYGON (((126.8798227580196 37.52219530320006, 126.8798054802541 37.52138057002454, 126.8794730017385 37.51677180493008, 126.8784581524498 37.51428213956806, 126.8783973792883 37.51429510475389, 126.8769584074076 37.51460208529789, 126.8717635529844 37.51590409941056, 126.8700013328322 37.51849415625716, 126.8700420240865 37.51861358670377, 126.8702321688546 37.51916292774124, 126.8706696844681 37.52100505011121, 126.8710521660895 37.52263673498894, 126.8711583668483 37.52312966240473, 126.8744538328839 37.52266589684996, 126.8798227580196 37.52219530320006)))"
235,서울특별시,양천구,신정3동,11470640,48467,23664,24803,"MULTIPOLYGON (((126.8516123006577 37.52172152317272, 126.8524608887322 37.52124846420771, 126.8559378538257 37.51368152911408, 126.858155804753 37.50994514085227, 126.8560858472955 37.50946851466372, 126.8550748626048 37.50992379177743, 126.8540242709842 37.51030337801248, 126.8529024426636 37.51057665595959, 126.8512431820223 37.51003012413108, 126.8471813344712 37.50879204972308, 126.8452943891224 37.50787100433432, 126.8445383266275 37.50643848308649, 126.8423284007361 37.50488594311254, 126.840617935427 37.5039930839468, 126.8389828050208 37.5029011978253, 126.8383816221437 37.50147482480303, 126.8383636857055 37.50014195093869, 126.8368887709668 37.50063044215423, 126.8364139985807 37.50065031882215, 126.8364565639848 37.50077126682277, 126.8365264323814 37.50096980320156, 126.8364178026688 37.502457548209, 126.8361715407997 37.50303866226452, 126.8356961108277 37.50338638945685, 126.8353480513325 37.50348358006146, 126.8343379000366 37.50376745063463, 126.8342407558259 37.50383408979962, 126.8338768789597 37.50408370435296, 126.8326423018806 37.50503104014351, 126.8306426973103 37.50683481893005, 126.8306750051046 37.5075729819132, 126.8291976060468 37.5086180529486, 126.8248500075126 37.50822147605434, 126.8247949083413 37.50829216307102, 126.8243305364824 37.50889564591363, 126.8240123323572 37.51061881937749, 126.8231401322904 37.5160489145586, 126.8231521124724 37.51607306722703, 126.8231720832581 37.51611331868892, 126.823210310857 37.51618677225442, 126.8241059503125 37.51709775553854, 126.825420436224 37.51909171900803, 126.8279491491195 37.51874774656003, 126.8284816558689 37.51867528665645, 126.8296449875458 37.51851629153796, 126.8309134050072 37.51778210738919, 126.8315277171701 37.51710056051275, 126.8321518397074 37.51642808017466, 126.8321789643017 37.51640006641625, 126.832270689928 37.51630938570816, 126.8338526732964 37.51524227110673, 126.8343798266179 37.51544169198075, 126.8349288503794 37.51564938545428, 126.8352687789409 37.51497317494194, 126.8354035296676 37.51485328773841, 126.8355598695967 37.51476853922294, 126.8361492483939 37.51445188356931, 126.8376650003567 37.51367733739046, 126.8414478769471 37.51311261298428, 126.8422530713399 37.51306752547605, 126.8425359996884 37.51314346200965, 126.8462240755858 37.51492607138799, 126.8485664084475 37.51599446722089, 126.8484807234708 37.51698365951524, 126.8485050107992 37.51702529880038, 126.8485172057946 37.5172495774956, 126.8485475025929 37.51783224036172, 126.8485486917418 37.51785816159848, 126.8486338807838 37.51977399632351, 126.8486383535949 37.51991034994398, 126.8486632117853 37.52071177402568, 126.8475037657064 37.52156115285333, 126.846924644949 37.52194034435039, 126.8468103248343 37.52207024987106, 126.8469058199253 37.52215077171815, 126.8470202623606 37.52224717273834, 126.8472920268123 37.52239063729067, 126.847598207521 37.52248133714392, 126.8479987822565 37.52253425006497, 126.8485342897586 37.52252368495845, 126.8516123006577 37.52172152317272)))"
236,서울특별시,양천구,신정6동,11470670,25291,12314,12977,"MULTIPOLYGON (((126.8711583668483 37.52312966240473, 126.8710521660895 37.52263673498894, 126.8706696844681 37.52100505011121, 126.8702321688546 37.51916292774124, 126.8700420240865 37.51861358670377, 126.8700013328322 37.51849415625716, 126.8717635529844 37.51590409941056, 126.8769584074076 37.51460208529789, 126.8783973792883 37.51429510475389, 126.8784581524498 37.51428213956806, 126.8734788432939 37.50852330999402, 126.8724530007956 37.50966925298171, 126.8714293229989 37.51081303229513, 126.8714035566831 37.5108421665425, 126.8707439325213 37.51200705180117, 126.8706814784385 37.51211826120204, 126.8703372605965 37.51283613709087, 126.8700935309191 37.5133449568109, 126.8699738857543 37.51359495717775, 126.869919317737 37.51370865086091, 126.8697521808781 37.51405684310582, 126.8640238884876 37.51206507951225, 126.8640071605758 37.51209490525883, 126.863739260815 37.51257906490126, 126.8623655001129 37.51506397955957, 126.863182391801 37.51536123534731, 126.8625966664261 37.51687459664348, 126.8652121689269 37.51777876552408, 126.8660597564005 37.51807738322443, 126.8673297255469 37.51852585416795, 126.8660315567504 37.52124322118843, 126.8653968185938 37.52256707561142, 126.8685903383835 37.52396322341522, 126.8711583668483 37.52312966240473)))"
237,서울특별시,양천구,신정7동,11470680,30930,15006,15924,"MULTIPOLYGON (((126.8734788432939 37.50852330999402, 126.8712606761671 37.50562598499916, 126.8696375825122 37.50539988337436, 126.8645744823059 37.50500597394642, 126.8635280690847 37.50496939956881, 126.8633885502563 37.50507793657906, 126.8631678667601 37.50525138383719, 126.8627534565591 37.50600072080719, 126.862459846537 37.5066863463882, 126.8601056781365 37.50668732796839, 126.8596810883377 37.5073946498164, 126.8595957132352 37.50753727641642, 126.858155804753 37.50994514085227, 126.8559378538257 37.51368152911408, 126.8562876195844 37.51379945217542, 126.8567910039123 37.51397003126517, 126.8574891842615 37.51421047526459, 126.8584460589884 37.51454016252482, 126.8589479950603 37.51472339484337, 126.8587690089399 37.51507246059894, 126.8587683005342 37.51539594211519, 126.8588794664267 37.51554526826983, 126.8591570328402 37.51567504115953, 126.8592119524395 37.51570030200461, 126.8625966664261 37.51687459664348, 126.863182391801 37.51536123534731, 126.8623655001129 37.51506397955957, 126.863739260815 37.51257906490126, 126.8640071605758 37.51209490525883, 126.8640238884876 37.51206507951225, 126.8697521808781 37.51405684310582, 126.869919317737 37.51370865086091, 126.8699738857543 37.51359495717775, 126.8700935309191 37.5133449568109, 126.8703372605965 37.51283613709087, 126.8706814784385 37.51211826120204, 126.8707439325213 37.51200705180117, 126.8714035566831 37.5108421665425, 126.8714293229989 37.51081303229513, 126.8724530007956 37.50966925298171, 126.8734788432939 37.50852330999402)))"
238,서울특별시,양천구,목5동,11470550,42943,21204,21739,"MULTIPOLYGON (((126.8851569446344 37.54358960812174, 126.8861657442654 37.54359603285742, 126.8872937300841 37.5433979119727, 126.8877375587081 37.54267688337181, 126.8879060786972 37.54240172409167, 126.8890185070711 37.54037381656402, 126.8912995163831 37.53583041215344, 126.8916339201603 37.53446321210658, 126.8915251232347 37.53313879629866, 126.8910707817996 37.53229256696007, 126.8900435815924 37.53037971846126, 126.8884819009021 37.53072097060306, 126.8865092048257 37.53129203677788, 126.8864270089108 37.53131535577163, 126.8850654331224 37.53155839784986, 126.8837365723034 37.53177906120537, 126.8829522881839 37.53184031361199, 126.882591090727 37.53186803506275, 126.8825261741708 37.53187301360647, 126.8814801330651 37.53189457999601, 126.8808334785643 37.53185513201099, 126.8806023620007 37.53184040522279, 126.8796148222877 37.53175973357148, 126.875046465155 37.531261311763, 126.873933642554 37.53110556837687, 126.8703669403103 37.53062785597789, 126.8671871035582 37.53022008927621, 126.8678980891054 37.53161518925779, 126.8698721660942 37.53494060637511, 126.8699109222014 37.53500368213398, 126.8700180238433 37.53517798820264, 126.8701513277872 37.53539276920994, 126.8702383328396 37.53547773452172, 126.870565313296 37.5357960759872, 126.8708988863938 37.53608853793563, 126.8709687754957 37.53614967905472, 126.871116588027 37.53627898038118, 126.8713672962024 37.5364977652283, 126.8725363391996 37.53746617060789, 126.8726691570017 37.5375727845262, 126.8743730054951 37.53914002714675, 126.8774909563707 37.54149775311591, 126.8818877045188 37.54357817344732, 126.8834894186106 37.54401468654915, 126.8851569446344 37.54358960812174)))"
239,서울특별시,양천구,신정4동,11470650,35784,17532,18252,"MULTIPOLYGON (((126.8653968185938 37.52256707561142, 126.863242083937 37.5223188468647, 126.8619492101859 37.52217271000647, 126.8615610646925 37.52212837522772, 126.8593925471692 37.52187552210807, 126.8582634442282 37.52174207685863, 126.8568672652514 37.52157674626025, 126.8561597955505 37.52149289695699, 126.8554809844827 37.52141257987643, 126.854122970822 37.52125193188181, 126.8532135842791 37.52115006027179, 126.8529168128535 37.52111688746948, 126.8527506233255 37.52116484793041, 126.8524608887322 37.52124846420771, 126.8516123006577 37.52172152317272, 126.8516801344629 37.52262887722133, 126.8488955583255 37.52789881782952, 126.8519643459692 37.52828414082574, 126.8584854263651 37.52910504309805, 126.8640110353512 37.52979969525946, 126.8640497326266 37.52924442740505, 126.8641740612602 37.52751338135064, 126.8642131579701 37.52715755936369, 126.8643177413933 37.5262111434615, 126.864415365744 37.5258347935631, 126.8653968185938 37.52256707561142)))"
240,서울특별시,강서구,염창동,11500510,42478,20758,21720,"MULTIPOLYGON (((126.8831662843492 37.55446522843518, 126.8897544007029 37.55017183813918, 126.8866138037425 37.54745945376757, 126.8852754472667 37.54630327749581, 126.885722621944 37.54431813614695, 126.8857706731173 37.54423839161363, 126.8861657442654 37.54359603285742, 126.8851569446344 37.54358960812174, 126.8832474831551 37.54555697857488, 126.8807138463221 37.54787031656874, 126.8798806733279 37.54766548362601, 126.8794040373496 37.5475479686388, 126.878490688872 37.54730793958105, 126.8781353761917 37.54721455609788, 126.8778908852848 37.54717721438011, 126.877813230747 37.54716560329386, 126.8777233300041 37.54715491909874, 126.8773684323273 37.54711473652327, 126.8768461715786 37.54705565724711, 126.8750130968535 37.54695583436721, 126.8749463805087 37.54695238960052, 126.874891454919 37.54694955703867, 126.8746175492268 37.54694244619375, 126.874018558187 37.54692690572119, 126.8734706092402 37.54696568674522, 126.8730038932614 37.54701954346767, 126.8724215583822 37.54710883770095, 126.8720624169152 37.54721015940467, 126.871766967011 37.54729351257811, 126.8711631969141 37.54749084797478, 126.8707019494657 37.54765176034911, 126.8649828545064 37.55092804368461, 126.8650776139337 37.55105624495327, 126.86616970626 37.55255787285446, 126.8662074748489 37.55260990289621, 126.8664508111494 37.55295259300036, 126.8673189902771 37.55419760342147, 126.86451177981 37.55606533015744, 126.8643119548402 37.55618142822061, 126.8640830379136 37.55630751117161, 126.8630358459148 37.55687985282168, 126.8655963494407 37.559094043645, 126.8672059934991 37.5597077086374, 126.8673837024724 37.55978076844958, 126.8674124708637 37.55980908957278, 126.8674341839754 37.55983624620877, 126.8677176826644 37.56033015961615, 126.8692583211439 37.5638862757829, 126.8761341968334 37.55912658761509, 126.8831662843492 37.55446522843518)))"
241,서울특별시,강서구,등촌1동,11500520,23720,11213,12507,"MULTIPOLYGON (((126.8630358459148 37.55687985282168, 126.8640830379136 37.55630751117161, 126.8643119548402 37.55618142822061, 126.86451177981 37.55606533015744, 126.8673189902771 37.55419760342147, 126.8664508111494 37.55295259300036, 126.8662074748489 37.55260990289621, 126.86616970626 37.55255787285446, 126.8650776139337 37.55105624495327, 126.8649828545064 37.55092804368461, 126.8642847311346 37.55138951230217, 126.8577145910467 37.55407034413031, 126.8523083679434 37.55588862694494, 126.8551764215844 37.56106684831898, 126.8630358459148 37.55687985282168)))"
242,서울특별시,강서구,등촌2동,11500530,21922,10844,11078,"MULTIPOLYGON (((126.8642847311346 37.55138951230217, 126.862931847282 37.54701743995786, 126.862541025977 37.54585374025271, 126.8624250645519 37.54543271595348, 126.8621851118674 37.54455769471636, 126.862174458124 37.54447550567989, 126.8621594463982 37.54413687025475, 126.862294562993 37.5437446765309, 126.8623299288978 37.54364205104475, 126.8623436567476 37.5436028202059, 126.862939034815 37.54247349040538, 126.8636723578317 37.53928339616603, 126.8634948363395 37.53559931239673, 126.8627496694434 37.53555586235175, 126.86187663985 37.53551692832615, 126.8609803085331 37.53714393772144, 126.8606957300401 37.53857889100273, 126.8606728673833 37.53877154714066, 126.8606339413084 37.53910023758247, 126.8606220957389 37.53986575423134, 126.860639383468 37.540367784855, 126.8606076323057 37.54077209189359, 126.8604785349459 37.54155781697951, 126.8597110878914 37.54195250353322, 126.8579787858684 37.5424106705721, 126.8574902930705 37.54221570251242, 126.8559445397798 37.54269589372217, 126.8556390151514 37.54275508392539, 126.8550930897974 37.54310680097404, 126.8545568762951 37.54345234475638, 126.8545469805501 37.54348581619747, 126.854522669315 37.54356808427745, 126.8545532042308 37.54388259529859, 126.8548257717697 37.54419054221429, 126.8549014546293 37.54460332196432, 126.8549028091431 37.54502020141086, 126.8548341086879 37.54609580647531, 126.8558133166564 37.54700024410451, 126.8561222903938 37.54736146222334, 126.8565462551116 37.54815397766986, 126.8567071471649 37.54845515529767, 126.8570584773834 37.54923335179239, 126.8570433089045 37.54926878216463, 126.8570028818405 37.54936374398445, 126.8568267448909 37.54977973573585, 126.8574081624558 37.5508633085122, 126.8579798944986 37.55143877132641, 126.8577145910467 37.55407034413031, 126.8642847311346 37.55138951230217)))"
243,서울특별시,강서구,등촌3동,11500535,32715,15551,17164,"MULTIPOLYGON (((126.8488300386692 37.56440292703702, 126.8551764215844 37.56106684831898, 126.8523083679434 37.55588862694494, 126.8457213824159 37.55782284180649, 126.8382161097713 37.55856513936558, 126.8385726611442 37.55961498809704, 126.8385892055452 37.55966465459132, 126.8387753028001 37.56022678234904, 126.8393521607762 37.56197523564512, 126.8393618089515 37.56200458323806, 126.8398369706362 37.56349220049012, 126.8408138328726 37.56661181094699, 126.840873123847 37.56684162251371, 126.8409540508677 37.56715599785752, 126.8459234437711 37.56473385694889, 126.8488300386692 37.56440292703702)))"
244,서울특별시,강서구,화곡본동,11500590,36064,17571,18493,"MULTIPOLYGON (((126.8548341086879 37.54609580647531, 126.8549028091431 37.54502020141086, 126.8549014546293 37.54460332196432, 126.8548257717697 37.54419054221429, 126.8545532042308 37.54388259529859, 126.854522669315 37.54356808427745, 126.8545469805501 37.54348581619747, 126.8545568762951 37.54345234475638, 126.8550930897974 37.54310680097404, 126.8556390151514 37.54275508392539, 126.8559445397798 37.54269589372217, 126.8559235024443 37.54233413037434, 126.8558206474512 37.54220174754366, 126.8557135756101 37.54206483488657, 126.8554461784996 37.54181550560338, 126.8540630638311 37.54091336239426, 126.8526928023261 37.54031161980195, 126.8524722551583 37.54022526049664, 126.8522638508109 37.54010919594512, 126.8522187548374 37.53985664391568, 126.8522119004919 37.53981810533727, 126.8522122180405 37.5395354315736, 126.8523799434088 37.53813813896332, 126.8533869365136 37.53679276499494, 126.8517549030465 37.53662833679751, 126.8521016285646 37.53849940396514, 126.8520168879858 37.53870934013396, 126.851556141098 37.53899440330792, 126.847714079868 37.53890226186078, 126.8472170143176 37.53878229060722, 126.8458705172542 37.53827269984227, 126.8449433044491 37.53773658182154, 126.8436889876216 37.53669081634307, 126.840437342383 37.54162446438571, 126.8411258825384 37.54191443749968, 126.8414128701993 37.54203551443855, 126.8418902684711 37.54229393268035, 126.8419499034844 37.54233867428739, 126.8420490733032 37.54241309030231, 126.8422170882949 37.54254024346905, 126.8424597873076 37.54277819818417, 126.8427187768748 37.54304582611063, 126.8429288337293 37.5432630285647, 126.8429505727301 37.54328568314766, 126.8431069060235 37.54344879498261, 126.8431629928133 37.54351623913329, 126.8432189496252 37.54358354282559, 126.8437978439369 37.54428863473085, 126.8438244115902 37.54432483615322, 126.8444585196334 37.54519139558217, 126.8470697671513 37.54885632780091, 126.8478630800462 37.5489349980795, 126.8491293677869 37.54830154947733, 126.8491979571979 37.54802119848794, 126.8492613618853 37.54776200406513, 126.8519628786602 37.54570264533452, 126.8527012486794 37.54548811925601, 126.8528628261688 37.5454574578377, 126.8533104576636 37.54540132285615, 126.8535794640854 37.54538364226212, 126.8548341086879 37.54609580647531)))"
245,서울특별시,강서구,화곡2동,11500550,19655,9561,10094,"MULTIPOLYGON (((126.8584854263651 37.52910504309805, 126.8519643459692 37.52828414082574, 126.8517925951845 37.52908922803454, 126.8516999575594 37.52952362854545, 126.8514275450673 37.53088946719239, 126.8514203627855 37.530961472405, 126.8513973343954 37.53119237916125, 126.8513702121784 37.53146601429798, 126.8510947384846 37.53558252773188, 126.8515310860138 37.53627381452892, 126.8517549030465 37.53662833679751, 126.8533869365136 37.53679276499494, 126.854695810104 37.53628503072295, 126.8576306879865 37.53342460984166, 126.8584854263651 37.52910504309805)))"
246,서울특별시,강서구,화곡3동,11500560,22698,10884,11814,"MULTIPOLYGON (((126.8362989120999 37.54797265226944, 126.8363899766804 37.54672254969953, 126.8365032535196 37.54623533391823, 126.8365665312021 37.54596522770807, 126.8367983474861 37.54551028316735, 126.8369646969583 37.545261094404, 126.8371195661695 37.54502986782517, 126.8371516660285 37.54499962766248, 126.8376411175316 37.54453592863774, 126.837879474246 37.54429286055158, 126.8404043980761 37.5416642730341, 126.8337786381739 37.53987114976861, 126.8334859996087 37.54079562907653, 126.8333266955102 37.54128821591202, 126.8332786037656 37.54143130322322, 126.8331398865925 37.54184148790216, 126.8314262438318 37.54178447720044, 126.8306921034128 37.54176003800688, 126.8304480918408 37.54175189457496, 126.8300838260738 37.54171914678337, 126.829919308284 37.54613280657835, 126.8298809632296 37.54638609184613, 126.829828415427 37.54673370319829, 126.8297772281725 37.54707280453209, 126.8299715065445 37.54717866126845, 126.8333303912656 37.54797508244995, 126.8344473133495 37.54797462339077, 126.8346975939674 37.54797392473371, 126.8362989120999 37.54797265226944)))"
247,서울특별시,강서구,화곡4동,11500570,22175,10854,11321,"MULTIPOLYGON (((126.8634948363395 37.53559931239673, 126.8640110353512 37.52979969525946, 126.8584854263651 37.52910504309805, 126.8576306879865 37.53342460984166, 126.854695810104 37.53628503072295, 126.8533869365136 37.53679276499494, 126.8523799434088 37.53813813896332, 126.8522122180405 37.5395354315736, 126.8522119004919 37.53981810533727, 126.8522187548374 37.53985664391568, 126.8522638508109 37.54010919594512, 126.8524722551583 37.54022526049664, 126.8526928023261 37.54031161980195, 126.8540630638311 37.54091336239426, 126.8554461784996 37.54181550560338, 126.8557135756101 37.54206483488657, 126.8558206474512 37.54220174754366, 126.8559235024443 37.54233413037434, 126.8559445397798 37.54269589372217, 126.8574902930705 37.54221570251242, 126.8579787858684 37.5424106705721, 126.8597110878914 37.54195250353322, 126.8604785349459 37.54155781697951, 126.8606076323057 37.54077209189359, 126.860639383468 37.540367784855, 126.8606220957389 37.53986575423134, 126.8606339413084 37.53910023758247, 126.8606728673833 37.53877154714066, 126.8606957300401 37.53857889100273, 126.8609803085331 37.53714393772144, 126.86187663985 37.53551692832615, 126.8627496694434 37.53555586235175, 126.8634948363395 37.53559931239673)))"
248,서울특별시,강서구,화곡6동,11500591,24930,12316,12614,"MULTIPOLYGON (((126.8523083679434 37.55588862694494, 126.8577145910467 37.55407034413031, 126.8579798944986 37.55143877132641, 126.8574081624558 37.5508633085122, 126.8568267448909 37.54977973573585, 126.8570028818405 37.54936374398445, 126.8570433089045 37.54926878216463, 126.8570584773834 37.54923335179239, 126.8567071471649 37.54845515529767, 126.8565462551116 37.54815397766986, 126.8561222903938 37.54736146222334, 126.8558133166564 37.54700024410451, 126.8548341086879 37.54609580647531, 126.8535794640854 37.54538364226212, 126.8533104576636 37.54540132285615, 126.8528628261688 37.5454574578377, 126.8527012486794 37.54548811925601, 126.8519628786602 37.54570264533452, 126.8492613618853 37.54776200406513, 126.8491979571979 37.54802119848794, 126.8491293677869 37.54830154947733, 126.8478630800462 37.5489349980795, 126.8470697671513 37.54885632780091, 126.8463642000278 37.54920054740032, 126.8444101801377 37.55175638475928, 126.844279046367 37.55203047166437, 126.8442387465671 37.55226910383892, 126.8442312762994 37.55231412951607, 126.8442966666444 37.55296858668789, 126.8455984795177 37.55608313708732, 126.8457213824159 37.55782284180649, 126.8523083679434 37.55588862694494)))"
249,서울특별시,강서구,화곡8동,11500593,26593,12780,13813,"MULTIPOLYGON (((126.8517549030465 37.53662833679751, 126.8515310860138 37.53627381452892, 126.8510947384846 37.53558252773188, 126.8513702121784 37.53146601429798, 126.8513973343954 37.53119237916125, 126.8514203627855 37.530961472405, 126.8514275450673 37.53088946719239, 126.8516999575594 37.52952362854545, 126.8517925951845 37.52908922803454, 126.8519643459692 37.52828414082574, 126.8488955583255 37.52789881782952, 126.8485345599619 37.52851281666525, 126.8473146717468 37.53075188777137, 126.8472526801224 37.5308668057524, 126.8473748156045 37.53091941006358, 126.8468670133519 37.53182328889452, 126.846765406729 37.53198881441956, 126.8464356787635 37.53252594927719, 126.8460554283871 37.53308986811131, 126.845840271395 37.53320891245296, 126.8436889876216 37.53669081634307, 126.8449433044491 37.53773658182154, 126.8458705172542 37.53827269984227, 126.8472170143176 37.53878229060722, 126.847714079868 37.53890226186078, 126.851556141098 37.53899440330792, 126.8520168879858 37.53870934013396, 126.8521016285646 37.53849940396514, 126.8517549030465 37.53662833679751)))"
250,서울특별시,강서구,가양1동,11500603,34199,16048,18151,"MULTIPOLYGON (((126.8509394260532 37.57561931537229, 126.8508208148823 37.57279522716041, 126.8495174827784 37.5709628468593, 126.8488741612757 37.57017542672067, 126.8484831408179 37.56969864578699, 126.8481358509579 37.56927473612085, 126.8496885180716 37.56830370662369, 126.8508465530988 37.56730283300923, 126.8494076546684 37.56519257636723, 126.8488300386692 37.56440292703702, 126.8459234437711 37.56473385694889, 126.8409540508677 37.56715599785752, 126.840873123847 37.56684162251371, 126.8408138328726 37.56661181094699, 126.8398369706362 37.56349220049012, 126.8393618089515 37.56200458323806, 126.8393521607762 37.56197523564512, 126.8387753028001 37.56022678234904, 126.8385892055452 37.55966465459132, 126.8385726611442 37.55961498809704, 126.8382161097713 37.55856513936558, 126.8269637081 37.55970035472775, 126.8272211237018 37.56183841347961, 126.8277978174779 37.56662792872272, 126.8242004213563 37.56693193689205, 126.823156169901 37.56702000752993, 126.822997901097 37.56738411571123, 126.8226075253872 37.5685243518126, 126.8225944788511 37.56863581775718, 126.8225885908293 37.56873831137712, 126.8225914587923 37.56878423307144, 126.822594159652 37.56882735063964, 126.8226115054352 37.56889760144904, 126.8226351214395 37.5689932068677, 126.8226481538753 37.56903834863449, 126.822760275744 37.56963049611549, 126.8227019823246 37.57067571564395, 126.8223955956343 37.57269859096845, 126.8223620472895 37.57282671304433, 126.8222944780848 37.57307882631184, 126.8220810330782 37.57328040205018, 126.8211878000274 37.57406281311805, 126.8210973459354 37.57420312714945, 126.8209461337745 37.57445960769531, 126.8209133192722 37.57451528391144, 126.820681352878 37.57494986284608, 126.8199375534721 37.57837640891018, 126.8208222971146 37.58092614515635, 126.8222907816872 37.58309267386287, 126.8218053770693 37.58330508027217, 126.8268261185208 37.58835440914611, 126.8509394260532 37.57561931537229)))"
251,서울특별시,강서구,가양2동,11500604,15301,7284,8017,"MULTIPOLYGON (((126.85775240042 37.57464240610413, 126.8574143359696 37.57107257166085, 126.8584034858136 37.5696211589387, 126.8603306129429 37.56870889550703, 126.8582537114699 37.56587864850401, 126.8573226563318 37.56460945153696, 126.8562662105633 37.56286635964489, 126.856153876004 37.56268097190031, 126.8554547307236 37.5615268187865, 126.8551764215844 37.56106684831898, 126.8488300386692 37.56440292703702, 126.8494076546684 37.56519257636723, 126.8508465530988 37.56730283300923, 126.8496885180716 37.56830370662369, 126.8481358509579 37.56927473612085, 126.8484831408179 37.56969864578699, 126.8488741612757 37.57017542672067, 126.8495174827784 37.5709628468593, 126.8508208148823 37.57279522716041, 126.8509394260532 37.57561931537229, 126.8566888285887 37.5747688658161, 126.85775240042 37.57464240610413)))"
252,서울특별시,강서구,가양3동,11500605,16277,7652,8625,"MULTIPOLYGON (((126.8692583211439 37.5638862757829, 126.8677176826644 37.56033015961615, 126.8674341839754 37.55983624620877, 126.8674124708637 37.55980908957278, 126.8673837024724 37.55978076844958, 126.8672059934991 37.5597077086374, 126.8655963494407 37.559094043645, 126.8630358459148 37.55687985282168, 126.8551764215844 37.56106684831898, 126.8554547307236 37.5615268187865, 126.856153876004 37.56268097190031, 126.8562662105633 37.56286635964489, 126.8573226563318 37.56460945153696, 126.8582537114699 37.56587864850401, 126.8603306129429 37.56870889550703, 126.8605076214259 37.56862532577344, 126.8642204360812 37.56686861025829, 126.8662839125682 37.56589160853773, 126.8692583211439 37.5638862757829)))"
253,서울특별시,강서구,발산1동,11500611,38559,18367,20192,"MULTIPOLYGON (((126.8269637081 37.55970035472775, 126.8382161097713 37.55856513936558, 126.8363582551301 37.55264621632339, 126.8363433696296 37.55259735648289, 126.8363164237419 37.54799641097103, 126.8362989120999 37.54797265226944, 126.8346975939674 37.54797392473371, 126.8344473133495 37.54797462339077, 126.8333303912656 37.54797508244995, 126.8299715065445 37.54717866126845, 126.8297772281725 37.54707280453209, 126.829828415427 37.54673370319829, 126.8298809632296 37.54638609184613, 126.829919308284 37.54613280657835, 126.8298799386134 37.54618441040766, 126.8296793163264 37.54638719161765, 126.8293731038718 37.54652855015457, 126.8291333824311 37.54651366824061, 126.8288931117384 37.5464098020886, 126.8288620941734 37.54637949387842, 126.8287331435789 37.54625338398301, 126.8282337996752 37.54564383630436, 126.8280841452093 37.54540919068952, 126.8277158907672 37.54426576814488, 126.8275125912044 37.54350635499691, 126.8274562046906 37.54320545368986, 126.827124357932 37.54246309105373, 126.8268141412518 37.54189662184648, 126.8265544837228 37.54166007431613, 126.8259431509637 37.54125193314932, 126.8256649854365 37.54112308868118, 126.8254728287336 37.54106432768259, 126.8254095200347 37.54104497470419, 126.8247831446914 37.54098954932963, 126.8221471074897 37.54067925643016, 126.8208573178867 37.54076648649275, 126.8201489579634 37.54075897618102, 126.8199285003956 37.5407566341121, 126.8185876688603 37.54069933037106, 126.8176939432883 37.54064346904187, 126.8174013769436 37.54060797778136, 126.8169816640448 37.54055578762254, 126.8168692665508 37.54054180656221, 126.8168234891835 37.54053579114992, 126.8166629348824 37.54051469908351, 126.8162157497442 37.54052225053042, 126.8146568556624 37.54063827458005, 126.8135881028678 37.54285162597785, 126.8146989218305 37.54392616981378, 126.814790139383 37.54402034873817, 126.8149201894414 37.54417757561654, 126.8149639289784 37.54426796369555, 126.815106965293 37.5445639842137, 126.8152760620563 37.54495028817762, 126.8161056666166 37.54893227117962, 126.8145732296611 37.55062128879073, 126.816103741128 37.55216357112811, 126.8170354070853 37.55297761641155, 126.817783955675 37.55334012373178, 126.8191999841216 37.55439288036509, 126.8216193967303 37.55620409719974, 126.8227583352759 37.55706952695686, 126.8231497045943 37.55740942284092, 126.8234103067093 37.55801368870114, 126.8235711738198 37.55914923706493, 126.8235965392177 37.55932856002983, 126.8235757440708 37.55944273096419, 126.8235258262281 37.55971675915426, 126.8235079473406 37.55981328950346, 126.8234670468396 37.5600341451217, 126.8234646851697 37.5600611727254, 126.8269637081 37.55970035472775)))"
254,서울특별시,강서구,공항동,11500620,28336,14533,13803,"MULTIPOLYGON (((126.8110377438503 37.56405782291434, 126.8111844431108 37.56395155467598, 126.8112414172614 37.56391583348189, 126.8123598385515 37.56396749226141, 126.8136816370934 37.56436156218639, 126.8164511977663 37.56462063618841, 126.8165136824635 37.56461473003829, 126.8165126079245 37.56450715698054, 126.8165161123127 37.56309086433063, 126.8212870536133 37.56245758153034, 126.8272211237018 37.56183841347961, 126.8269637081 37.55970035472775, 126.8234646851697 37.5600611727254, 126.8234670468396 37.5600341451217, 126.8235079473406 37.55981328950346, 126.8235258262281 37.55971675915426, 126.8235757440708 37.55944273096419, 126.8235965392177 37.55932856002983, 126.8235711738198 37.55914923706493, 126.8234103067093 37.55801368870114, 126.8231497045943 37.55740942284092, 126.8227583352759 37.55706952695686, 126.8216193967303 37.55620409719974, 126.8191999841216 37.55439288036509, 126.817783955675 37.55334012373178, 126.8170354070853 37.55297761641155, 126.816103741128 37.55216357112811, 126.8145732296611 37.55062128879073, 126.8161056666166 37.54893227117962, 126.8152760620563 37.54495028817762, 126.815106965293 37.5445639842137, 126.8149639289784 37.54426796369555, 126.8149201894414 37.54417757561654, 126.814790139383 37.54402034873817, 126.8146989218305 37.54392616981378, 126.8135881028678 37.54285162597785, 126.8131987747293 37.54210349962685, 126.8129122208355 37.5415666608302, 126.8125175958812 37.5409345501887, 126.8122497843889 37.54097693116981, 126.8120074711049 37.54101608006864, 126.8103755347979 37.54160933299899, 126.8094448583992 37.54234744534646, 126.8092965952372 37.54316194487561, 126.8091628428303 37.54322916875348, 126.8089653963683 37.54323477438491, 126.8059750464387 37.54320595140503, 126.8028491826817 37.543081647758, 126.8016119624313 37.54245579022187, 126.7997701066775 37.54044390113104, 126.7992427747695 37.53928775413662, 126.7987185825475 37.53767504421919, 126.7944008002434 37.5358308630404, 126.7939999279998 37.53685599843281, 126.7938383833528 37.5373327443893, 126.7937378532955 37.53944015907601, 126.7938673718994 37.53962996327436, 126.7940211694731 37.53985534426984, 126.7933358027529 37.54156266810374, 126.7901780481517 37.54384414352022, 126.7850810616181 37.5461620812747, 126.7849960783617 37.54616113495226, 126.7831170616007 37.54614636170862, 126.7830611768872 37.54614602239982, 126.7818556105635 37.54614207629071, 126.7812011709551 37.54614034660553, 126.780331432794 37.54616208903926, 126.7799011458255 37.54624734733923, 126.7766463680963 37.54825222393661, 126.7763260589369 37.54844953048062, 126.7757576353621 37.54876491248373, 126.7754802830817 37.54891080542941, 126.7751732875186 37.54897652178136, 126.774751607466 37.54897505909789, 126.7736112487688 37.54888129508291, 126.7734126151698 37.54886736311804, 126.7711628364747 37.54870960365766, 126.7705770157953 37.5495571071918, 126.7702555911634 37.55002220450562, 126.7685565272256 37.55221772030703, 126.767958935224 37.55269285333141, 126.767767370405 37.55325274926344, 126.7677107466177 37.55418855255471, 126.7672042816533 37.55415254288631, 126.7645841945236 37.55510099034409, 126.7644351633531 37.55517294512883, 126.7643446230654 37.55521687110915, 126.7643041751636 37.55529130402035, 126.7642782965098 37.55533906695236, 126.7643097577292 37.55537756990068, 126.7643300465778 37.55540135556736, 126.7643913360331 37.55542877761359, 126.7644730055921 37.5554649533084, 126.7645668385752 37.55550626032339, 126.7693695955983 37.5571395620627, 126.7694579048058 37.55715362860729, 126.7697263874927 37.55719584983483, 126.7703137410812 37.5571927213452, 126.770727512137 37.55716471349388, 126.7756325044262 37.56180294934664, 126.7754645484757 37.56537865424335, 126.7769564768265 37.56634098049375, 126.7805265626019 37.56832834425121, 126.7825026883342 37.5702298005416, 126.7819702017786 37.57168927143186, 126.7819049635366 37.57184543509886, 126.7825745898584 37.57334795002309, 126.7826188582499 37.5734219258992, 126.7827021860888 37.57356090378295, 126.7828857043528 37.57370214874968, 126.7845813089372 37.57467136245663, 126.788071575697 37.57674479831825, 126.7887652115062 37.57729992994732, 126.7933926201238 37.57653274196113, 126.795101661994 37.57513800019632, 126.7963125343875 37.57362784876158, 126.796481856769 37.57341670649562, 126.7985966402619 37.57144868605892, 126.7990881672967 37.57104556972144, 126.8002345532486 37.57010466382663, 126.8000231314374 37.56967024872412, 126.798726812214 37.56711055881818, 126.7986681249961 37.56699537149605, 126.7996549210096 37.56506141362394, 126.8017188978111 37.5623140975885, 126.8027677627628 37.56218903900362, 126.8076660969548 37.56170691776367, 126.8091161233544 37.56254689849212, 126.810187031586 37.56336887429895, 126.8104223948971 37.5635538964204, 126.8110377438503 37.56405782291434)))"
255,서울특별시,강서구,방화1동,11500630,45847,22412,23435,"MULTIPOLYGON (((126.8220810330782 37.57328040205018, 126.8222944780848 37.57307882631184, 126.8223620472895 37.57282671304433, 126.8223955956343 37.57269859096845, 126.8227019823246 37.57067571564395, 126.822760275744 37.56963049611549, 126.8226481538753 37.56903834863449, 126.8226351214395 37.5689932068677, 126.8226115054352 37.56889760144904, 126.822594159652 37.56882735063964, 126.8225914587923 37.56878423307144, 126.8225885908293 37.56873831137712, 126.8225944788511 37.56863581775718, 126.8226075253872 37.5685243518126, 126.822997901097 37.56738411571123, 126.823156169901 37.56702000752993, 126.8242004213563 37.56693193689205, 126.8277978174779 37.56662792872272, 126.8272211237018 37.56183841347961, 126.8212870536133 37.56245758153034, 126.8165161123127 37.56309086433063, 126.8165126079245 37.56450715698054, 126.8165136824635 37.56461473003829, 126.8164511977663 37.56462063618841, 126.8136816370934 37.56436156218639, 126.8123598385515 37.56396749226141, 126.8112414172614 37.56391583348189, 126.8111844431108 37.56395155467598, 126.8110377438503 37.56405782291434, 126.8123127464701 37.56584869291058, 126.8124782306971 37.56616619826628, 126.8125081497435 37.5662250145667, 126.8125922529979 37.56647001974551, 126.8126058846222 37.56652527913406, 126.8127460729668 37.56721484498863, 126.8128218870182 37.56812641347948, 126.8127969972994 37.56983430570168, 126.812795107267 37.56996273553241, 126.8127364329054 37.57010998103583, 126.8126690576612 37.57027859797323, 126.8124508482342 37.57068856323632, 126.8118976525086 37.5715055584647, 126.811504461365 37.57208575614389, 126.811246226118 37.5724594311087, 126.8109075899187 37.5729481886846, 126.810667373438 37.57328809969005, 126.8099722660378 37.57316407584623, 126.8097912363237 37.57313144363926, 126.8097286522135 37.57311981097003, 126.80936281235 37.57305440624155, 126.8088433256666 37.57296196658562, 126.8086795838869 37.572937865916, 126.8079926585807 37.57283924562046, 126.8074008990611 37.57275463670153, 126.8064793385117 37.57262305686394, 126.8063513910031 37.57260540502025, 126.8058316736067 37.5725696765093, 126.8057812665 37.57256938008557, 126.8041675877529 37.57256663935929, 126.8036231241908 37.57257853610663, 126.8027444574377 37.57459639301515, 126.803011357722 37.57452191429854, 126.8032426172003 37.57445737367995, 126.8039440161258 37.57407963442784, 126.8041370162795 37.57402662710265, 126.8051413783705 37.57402465665042, 126.8073364221514 37.57426738558244, 126.8073899229657 37.57441417958167, 126.8075333571916 37.57482287660257, 126.8075449659496 37.57486801160874, 126.8085942520339 37.57528990428617, 126.8086792031761 37.57528814847936, 126.8093354724378 37.57527283659484, 126.8100137385251 37.57525088959898, 126.81009586899 37.57524798961225, 126.8131075907944 37.57516302564787, 126.8138920282467 37.57514054743341, 126.8140160888922 37.57513692398593, 126.8142134509718 37.57513114844795, 126.8155119838563 37.57508235148297, 126.8155770793473 37.5750797094373, 126.8157789139691 37.57507150557116, 126.8165528055355 37.57501853286788, 126.8165510718543 37.57492162442454, 126.8165392313489 37.57428047875473, 126.8165066140728 37.5739772147589, 126.8165113796656 37.57337897872976, 126.8167725902352 37.57337373079437, 126.8168632009845 37.57337200184322, 126.8195560025224 37.57332446144775, 126.8209432876393 37.57330019088844, 126.8220810330782 37.57328040205018)))"
256,서울특별시,강서구,방화2동,11500640,24203,11982,12221,"MULTIPOLYGON (((126.8049359331122 37.60402118608447, 126.8055049155499 37.60368863759859, 126.8066411853273 37.60279173168918, 126.8068867277599 37.602579107219, 126.8071929453846 37.60231275838993, 126.8098727795109 37.5999500629248, 126.8100125395578 37.5998247662792, 126.8101312239412 37.59971835451404, 126.8109958193275 37.59894036987672, 126.8112842513444 37.59868066632504, 126.8124744019713 37.59760487698943, 126.8133746879204 37.59678990318254, 126.8160590045329 37.59435836359075, 126.8180520607784 37.59263820475388, 126.81485051511 37.58779302928968, 126.8146623190846 37.58747194057987, 126.8146506827609 37.58735131924075, 126.8145767034613 37.58383905577259, 126.8146366343255 37.58368925181175, 126.8146860810624 37.58364477669998, 126.8149994257229 37.58336154764854, 126.8146967099131 37.58279420136908, 126.8141337874097 37.58281233856142, 126.8116996075679 37.58302575707502, 126.811468576048 37.58305482978037, 126.8098625064187 37.58350738557526, 126.8083407081697 37.58303541623557, 126.8075955988576 37.58247109217608, 126.8068682662299 37.58167026680545, 126.8068377171632 37.58163635937993, 126.8068101075363 37.58160570500881, 126.8066080632762 37.58133411717654, 126.8061914113367 37.58061848586676, 126.8060806599897 37.58041943248947, 126.8054460234835 37.57924970295335, 126.8052705682811 37.57871022948355, 126.805240996071 37.57861418016525, 126.8040053135578 37.57448891310931, 126.8039440161258 37.57407963442784, 126.8032426172003 37.57445737367995, 126.803011357722 37.57452191429854, 126.8027444574377 37.57459639301515, 126.8036231241908 37.57257853610663, 126.8041675877529 37.57256663935929, 126.8057812665 37.57256938008557, 126.8058316736067 37.5725696765093, 126.8063513910031 37.57260540502025, 126.8064793385117 37.57262305686394, 126.8074008990611 37.57275463670153, 126.8079926585807 37.57283924562046, 126.8086795838869 37.572937865916, 126.8088433256666 37.57296196658562, 126.80936281235 37.57305440624155, 126.8097286522135 37.57311981097003, 126.8097912363237 37.57313144363926, 126.8099722660378 37.57316407584623, 126.810667373438 37.57328809969005, 126.8109075899187 37.5729481886846, 126.811246226118 37.5724594311087, 126.811504461365 37.57208575614389, 126.8118976525086 37.5715055584647, 126.8124508482342 37.57068856323632, 126.8126690576612 37.57027859797323, 126.8127364329054 37.57010998103583, 126.812795107267 37.56996273553241, 126.8127969972994 37.56983430570168, 126.8128218870182 37.56812641347948, 126.8127460729668 37.56721484498863, 126.8126058846222 37.56652527913406, 126.8125922529979 37.56647001974551, 126.8125081497435 37.5662250145667, 126.8124782306971 37.56616619826628, 126.8123127464701 37.56584869291058, 126.8110377438503 37.56405782291434, 126.8104223948971 37.5635538964204, 126.810187031586 37.56336887429895, 126.8091161233544 37.56254689849212, 126.8076660969548 37.56170691776367, 126.8027677627628 37.56218903900362, 126.8017188978111 37.5623140975885, 126.7996549210096 37.56506141362394, 126.7986681249961 37.56699537149605, 126.798726812214 37.56711055881818, 126.8000231314374 37.56967024872412, 126.8002345532486 37.57010466382663, 126.7990881672967 37.57104556972144, 126.7985966402619 37.57144868605892, 126.796481856769 37.57341670649562, 126.7963125343875 37.57362784876158, 126.795101661994 37.57513800019632, 126.7933926201238 37.57653274196113, 126.7887652115062 37.57729992994732, 126.7912461244063 37.58084086228319, 126.7927370074905 37.58017394470266, 126.7934015406711 37.58051530836386, 126.7936956740808 37.58154035610674, 126.793673641835 37.5816045499506, 126.794815762775 37.5833125439222, 126.7957218003213 37.58312063913964, 126.7959073330288 37.58315794816881, 126.7959488574884 37.58318410747366, 126.7962641837346 37.58344962965472, 126.7969029868863 37.58401902412006, 126.7970253483883 37.58418086857975, 126.797358311194 37.58558330126211, 126.7983385232829 37.58779289862741, 126.7986921366228 37.58810436569215, 126.7988278978474 37.58822394127765, 126.7996416460306 37.58802154107926, 126.8006778865457 37.58789804248698, 126.8007880474898 37.58800350606484, 126.8008815684266 37.5887521372121, 126.8008200767849 37.58896876954604, 126.8008090903493 37.58900746280175, 126.8006161774585 37.58927333965563, 126.7990633011859 37.59210896857013, 126.7975791272679 37.59575731101968, 126.7975349004068 37.59587093050769, 126.7972540955682 37.59659249049739, 126.797108147852 37.59728001547473, 126.7970654055984 37.59787864252289, 126.7970616805783 37.59793081659879, 126.7970217095685 37.59849066755093, 126.7971020103624 37.59891139373641, 126.7971391148689 37.59903686679605, 126.797231061514 37.59934254925097, 126.7974734438858 37.59999407851399, 126.7976146602521 37.60026194010597, 126.797915833386 37.60075486444948, 126.8003532862617 37.60381706876511, 126.8005998580656 37.60410358872229, 126.8009346994211 37.60433652672384, 126.8012780176158 37.60449854747942, 126.8018522700458 37.60464841182686, 126.8022196483839 37.60466072550323, 126.8023651519687 37.60465181437874, 126.8028905675609 37.60461962387557, 126.8035140026723 37.60450838485482, 126.8039694703231 37.60441305110245, 126.804321061048 37.60429457175218, 126.8049359331122 37.60402118608447)))"
257,서울특별시,강서구,방화3동,11500641,24582,11865,12717,"MULTIPOLYGON (((126.8268261185208 37.58835440914611, 126.8218053770693 37.58330508027217, 126.8222907816872 37.58309267386287, 126.8208222971146 37.58092614515635, 126.8199375534721 37.57837640891018, 126.820681352878 37.57494986284608, 126.8209133192722 37.57451528391144, 126.8209461337745 37.57445960769531, 126.8210973459354 37.57420312714945, 126.8211878000274 37.57406281311805, 126.8220810330782 37.57328040205018, 126.8209432876393 37.57330019088844, 126.8195560025224 37.57332446144775, 126.8168632009845 37.57337200184322, 126.8167725902352 37.57337373079437, 126.8165113796656 37.57337897872976, 126.8165066140728 37.5739772147589, 126.8165392313489 37.57428047875473, 126.8165510718543 37.57492162442454, 126.8165528055355 37.57501853286788, 126.8157789139691 37.57507150557116, 126.8155770793473 37.5750797094373, 126.8155119838563 37.57508235148297, 126.8142134509718 37.57513114844795, 126.8140160888922 37.57513692398593, 126.8138920282467 37.57514054743341, 126.8131075907944 37.57516302564787, 126.81009586899 37.57524798961225, 126.8100137385251 37.57525088959898, 126.8093354724378 37.57527283659484, 126.8086792031761 37.57528814847936, 126.8085942520339 37.57528990428617, 126.8075449659496 37.57486801160874, 126.8075333571916 37.57482287660257, 126.8073899229657 37.57441417958167, 126.8073364221514 37.57426738558244, 126.8051413783705 37.57402465665042, 126.8041370162795 37.57402662710265, 126.8039440161258 37.57407963442784, 126.8040053135578 37.57448891310931, 126.805240996071 37.57861418016525, 126.8052705682811 37.57871022948355, 126.8054460234835 37.57924970295335, 126.8060806599897 37.58041943248947, 126.8061914113367 37.58061848586676, 126.8066080632762 37.58133411717654, 126.8068101075363 37.58160570500881, 126.8068377171632 37.58163635937993, 126.8068682662299 37.58167026680545, 126.8075955988576 37.58247109217608, 126.8083407081697 37.58303541623557, 126.8098625064187 37.58350738557526, 126.811468576048 37.58305482978037, 126.8116996075679 37.58302575707502, 126.8141337874097 37.58281233856142, 126.8146967099131 37.58279420136908, 126.8149994257229 37.58336154764854, 126.8146860810624 37.58364477669998, 126.8146366343255 37.58368925181175, 126.8145767034613 37.58383905577259, 126.8146506827609 37.58735131924075, 126.8146623190846 37.58747194057987, 126.81485051511 37.58779302928968, 126.8180520607784 37.59263820475388, 126.8202587895872 37.59096413681588, 126.8204280731976 37.59083571576875, 126.8222492895264 37.58993245777744, 126.8238666618205 37.58925559137909, 126.8268261185208 37.58835440914611)))"
258,서울특별시,강서구,화곡1동,11500540,54681,26740,27941,"MULTIPOLYGON (((126.840437342383 37.54162446438571, 126.8436889876216 37.53669081634307, 126.845840271395 37.53320891245296, 126.8460554283871 37.53308986811131, 126.8464356787635 37.53252594927719, 126.846765406729 37.53198881441956, 126.8468670133519 37.53182328889452, 126.8473748156045 37.53091941006358, 126.8472526801224 37.5308668057524, 126.8473146717468 37.53075188777137, 126.8485345599619 37.52851281666525, 126.8488955583255 37.52789881782952, 126.840485322699 37.52653732844918, 126.8347266741849 37.53603400665195, 126.8351653501694 37.53691235409344, 126.8337786381739 37.53987114976861, 126.8404043980761 37.5416642730341, 126.840437342383 37.54162446438571)))"
259,서울특별시,강서구,우장산동,11500615,45305,21727,23578,"MULTIPOLYGON (((126.8457213824159 37.55782284180649, 126.8455984795177 37.55608313708732, 126.8442966666444 37.55296858668789, 126.8442312762994 37.55231412951607, 126.8442387465671 37.55226910383892, 126.844279046367 37.55203047166437, 126.8444101801377 37.55175638475928, 126.8463642000278 37.54920054740032, 126.8470697671513 37.54885632780091, 126.8444585196334 37.54519139558217, 126.8438244115902 37.54432483615322, 126.8437978439369 37.54428863473085, 126.8432189496252 37.54358354282559, 126.8431629928133 37.54351623913329, 126.8431069060235 37.54344879498261, 126.8429505727301 37.54328568314766, 126.8429288337293 37.5432630285647, 126.8427187768748 37.54304582611063, 126.8424597873076 37.54277819818417, 126.8422170882949 37.54254024346905, 126.8420490733032 37.54241309030231, 126.8419499034844 37.54233867428739, 126.8418902684711 37.54229393268035, 126.8414128701993 37.54203551443855, 126.8411258825384 37.54191443749968, 126.840437342383 37.54162446438571, 126.8404043980761 37.5416642730341, 126.837879474246 37.54429286055158, 126.8376411175316 37.54453592863774, 126.8371516660285 37.54499962766248, 126.8371195661695 37.54502986782517, 126.8369646969583 37.545261094404, 126.8367983474861 37.54551028316735, 126.8365665312021 37.54596522770807, 126.8365032535196 37.54623533391823, 126.8363899766804 37.54672254969953, 126.8362989120999 37.54797265226944, 126.8363164237419 37.54799641097103, 126.8363433696296 37.55259735648289, 126.8363582551301 37.55264621632339, 126.8382161097713 37.55856513936558, 126.8457213824159 37.55782284180649)))"
260,서울특별시,구로구,신도림동,11530510,37392,18293,19099,"MULTIPOLYGON (((126.8929696244947 37.50946107193752, 126.8951392320442 37.50815159034568, 126.8938556451389 37.50747806922447, 126.8914233198516 37.50751447887241, 126.8910495964876 37.5078774652268, 126.8899925870743 37.5081634769497, 126.8854539669502 37.50549337018443, 126.8829168960893 37.50375968638829, 126.8819764675698 37.50358351286609, 126.8817298164908 37.50365320363754, 126.8813742561433 37.50389583390398, 126.8813209709254 37.50393245619728, 126.8812327309338 37.503993114705, 126.8801360636838 37.50493158546576, 126.8784163363035 37.50492362107256, 126.8783361689954 37.50495587320219, 126.8781351997857 37.50503741525818, 126.8777742305242 37.505183885912, 126.8775379280143 37.50528291632785, 126.8770291753663 37.50549696436072, 126.8734788432939 37.50852330999402, 126.8784581524498 37.51428213956806, 126.8794730017385 37.51677180493008, 126.8817334166011 37.51581502279236, 126.8885217011426 37.51266489693496, 126.8896275505574 37.51208585237993, 126.8902886285903 37.51166789749873, 126.89044510236 37.51155828954258, 126.8906753601249 37.51133188631739, 126.8907923611343 37.5112018380099, 126.8908994500011 37.51108179034174, 126.8911868753152 37.51069569094397, 126.8912163968866 37.51065601507445, 126.8917480693434 37.50986935563009, 126.8929696244947 37.50946107193752)))"
261,서울특별시,구로구,구로1동,11530520,22120,10881,11239,"MULTIPOLYGON (((126.8801534881763 37.48734399127603, 126.8806588579626 37.48596867912071, 126.8781020277769 37.48629324420081, 126.8773709825015 37.48595927254647, 126.8770842379146 37.48583831978431, 126.8763410627301 37.48560569105042, 126.8755186414189 37.4854779062331, 126.8753222561957 37.48544820493883, 126.8747424680725 37.48538205210301, 126.8751517260486 37.48648498874045, 126.8752859603007 37.48853290104538, 126.8727803086423 37.48880355146688, 126.8700464352366 37.49191782917325, 126.8696532445064 37.49251741693241, 126.8696124460348 37.49340113495198, 126.8689082442587 37.49510029279732, 126.8683057762067 37.49510381307537, 126.8681934532679 37.49552577662323, 126.8680284188128 37.49706166449341, 126.8684107676805 37.49644283046339, 126.8712060398487 37.49696369871408, 126.8718327033247 37.49727574606308, 126.8729100043639 37.4978132679779, 126.8733200269927 37.49799120766659, 126.8750968434927 37.49866917087664, 126.8783484224009 37.499810341945, 126.8801641137406 37.50008397948085, 126.8801243897364 37.50000783205674, 126.8798656992226 37.49939693439133, 126.8797701607482 37.49906518558935, 126.8797365557593 37.49893994641306, 126.8797132432808 37.49885194208328, 126.8796806474222 37.49868952737262, 126.8796718230644 37.49864441338096, 126.8796350259335 37.49843465555347, 126.8796119688945 37.49827341759832, 126.8795915521369 37.49806558453007, 126.8795791975007 37.49790652094666, 126.8795713070843 37.49780337371575, 126.8795656067499 37.49772321347823, 126.8795688896198 37.49749802761907, 126.8795732370908 37.497314399728, 126.8795804795971 37.49717725179757, 126.8795832966547 37.49712404168102, 126.879592563895 37.4970294482552, 126.8798513263894 37.49463771341576, 126.8800046359618 37.49251357733046, 126.8799858386903 37.49222166531193, 126.8799807509791 37.49215291036344, 126.8798200386677 37.49132394769115, 126.8799152338324 37.48990030761533, 126.880008750391 37.48850820571184, 126.880133840495 37.48740132161623, 126.8801534881763 37.48734399127603)))"
262,서울특별시,구로구,구로3동,11530540,26460,13526,12934,"MULTIPOLYGON (((126.903226979492 37.48498628253719, 126.899468525752 37.48034441659667, 126.8989530177933 37.47895367065259, 126.8961675538531 37.4785531130379, 126.8960483773837 37.47878566328195, 126.8943814331967 37.4802012741004, 126.8934755917505 37.48025403031156, 126.8921115052932 37.48064902391688, 126.8913286936279 37.48338314675793, 126.8914259870203 37.483501950917, 126.8915566475545 37.48369190861108, 126.8913012771906 37.48379988259234, 126.8912530434299 37.48381991458385, 126.8910347328456 37.4838908980017, 126.8909892011053 37.48390535901134, 126.8880448875197 37.48470579807772, 126.8879727440702 37.48472515504731, 126.8879088111987 37.48474230022049, 126.8875114192476 37.48483938982995, 126.8865869922807 37.48495616409854, 126.8862101317963 37.48497539317863, 126.8864668329971 37.48529638410732, 126.8880171413962 37.48711575510327, 126.8883522645288 37.48744262381173, 126.8891539028959 37.48801953837534, 126.8895224325574 37.48827229940532, 126.8917486610621 37.48974099295266, 126.8953972611576 37.49203217901983, 126.8974176428072 37.48775889416138, 126.8975610640586 37.48759512821425, 126.8977026976685 37.48747642165152, 126.8985980563731 37.48672835090476, 126.8988359936735 37.48659097843399, 126.9002826926562 37.48576119676848, 126.9004505722706 37.48566520354548, 126.9027629200137 37.4850078036784, 126.9029073568314 37.48499143861561, 126.9029893856374 37.48498847306706, 126.903226979492 37.48498628253719)))"
263,서울특별시,구로구,구로4동,11530550,26504,13440,13064,"MULTIPOLYGON (((126.8953703961293 37.49210401109809, 126.8953972611576 37.49203217901983, 126.8917486610621 37.48974099295266, 126.8895224325574 37.48827229940532, 126.8891539028959 37.48801953837534, 126.8883522645288 37.48744262381173, 126.8880171413962 37.48711575510327, 126.8864668329971 37.48529638410732, 126.8862101317963 37.48497539317863, 126.8860530654307 37.48498340675444, 126.8855683935121 37.48609119732843, 126.8855244187719 37.48619575116335, 126.884809874817 37.48789672031732, 126.8844447359265 37.48892968729761, 126.8840715431571 37.49051573346122, 126.8841160526165 37.49053343465913, 126.8841898945114 37.49056262688062, 126.8848103440478 37.4904201374269, 126.8852020989526 37.4903301665092, 126.8855203904895 37.49024349964461, 126.8860412623091 37.49016101979674, 126.8879880121088 37.48992933244972, 126.8896594878419 37.49209064075185, 126.8904108206446 37.49320710509139, 126.8888188721015 37.49528600134448, 126.8935264738045 37.49772371857485, 126.8945462535908 37.49432239352335, 126.8953703961293 37.49210401109809)))"
264,서울특별시,구로구,구로5동,11530560,33690,16572,17118,"MULTIPOLYGON (((126.8938556451389 37.50747806922447, 126.893685131218 37.50441546253393, 126.8934035562961 37.50313460866683, 126.8933444586877 37.50257321291207, 126.8933387162642 37.50251737163815, 126.8933320398392 37.50230989994807, 126.8933234708761 37.5020210263414, 126.8933099111808 37.50151281883764, 126.8933240841092 37.50118040043836, 126.8933264993038 37.5011242197743, 126.8934438820498 37.49841285088337, 126.8934508232876 37.49825402383242, 126.8935264738045 37.49772371857485, 126.8888188721015 37.49528600134448, 126.8872233339024 37.49717293305375, 126.8846957001031 37.49905714338698, 126.8843722801954 37.49917826860986, 126.8843393929986 37.49919187890455, 126.8841573111998 37.49926728342493, 126.8841246389351 37.49928226393529, 126.8840650425473 37.49930961573805, 126.8839840958764 37.49935031788475, 126.8838512534132 37.49942567673734, 126.8837482188059 37.49948823399233, 126.8836173256747 37.49958444653796, 126.8835630756388 37.4996260944005, 126.8835269506418 37.49965382980053, 126.8835027588026 37.49967496646821, 126.8834692685017 37.49970422987348, 126.8808225887396 37.50202601629196, 126.8798204004839 37.5030158042717, 126.8812327309338 37.503993114705, 126.8813209709254 37.50393245619728, 126.8813742561433 37.50389583390398, 126.8817298164908 37.50365320363754, 126.8819764675698 37.50358351286609, 126.8829168960893 37.50375968638829, 126.8854539669502 37.50549337018443, 126.8899925870743 37.5081634769497, 126.8910495964876 37.5078774652268, 126.8914233198516 37.50751447887241, 126.8938556451389 37.50747806922447)))"
265,서울특별시,구로구,고척1동,11530720,24293,12179,12114,"MULTIPOLYGON (((126.8712606761671 37.50562598499916, 126.8680284188128 37.49706166449341, 126.8681934532679 37.49552577662323, 126.8641895705145 37.49400575957798, 126.8641106993599 37.49479174212108, 126.8636083020224 37.49610052764123, 126.8630995537794 37.49681098114218, 126.862836607115 37.49671942792459, 126.8625603083034 37.49661766185834, 126.8604986100101 37.49685889760952, 126.8566406434254 37.49755227123239, 126.8555515347732 37.49930847879986, 126.8556262994431 37.49998828058906, 126.8558003883705 37.50104043151453, 126.8558212327698 37.50116560682152, 126.8560453119274 37.50224394455856, 126.8571461841868 37.50217219921409, 126.8574099028118 37.5031651198012, 126.8570040630235 37.5034873798092, 126.8566203446494 37.5037917679111, 126.8566707420296 37.50393287852801, 126.8571690881358 37.50411924190378, 126.8573237021955 37.50416817841712, 126.8613575020943 37.50476614694504, 126.8627534565591 37.50600072080719, 126.8631678667601 37.50525138383719, 126.8633885502563 37.50507793657906, 126.8635280690847 37.50496939956881, 126.8645744823059 37.50500597394642, 126.8696375825122 37.50539988337436, 126.8712606761671 37.50562598499916)))"
266,서울특별시,구로구,고척2동,11530730,29019,14401,14618,"MULTIPOLYGON (((126.858155804753 37.50994514085227, 126.8595957132352 37.50753727641642, 126.8596810883377 37.5073946498164, 126.8601056781365 37.50668732796839, 126.862459846537 37.5066863463882, 126.8627534565591 37.50600072080719, 126.8613575020943 37.50476614694504, 126.8573237021955 37.50416817841712, 126.8571690881358 37.50411924190378, 126.8566707420296 37.50393287852801, 126.8566203446494 37.5037917679111, 126.8570040630235 37.5034873798092, 126.8574099028118 37.5031651198012, 126.8571461841868 37.50217219921409, 126.8560453119274 37.50224394455856, 126.8549850510626 37.50252771806726, 126.8546836217226 37.50259726047348, 126.8546271996157 37.50261022552576, 126.8535347924571 37.5006359250533, 126.8530051599811 37.49957735784857, 126.8529177976704 37.49954082525959, 126.8528254902116 37.49950313882419, 126.852739435186 37.49947900685162, 126.8524583372303 37.49965633052552, 126.8499768039879 37.50132400130452, 126.8484432622137 37.50289404464481, 126.8482682974815 37.5031736249253, 126.8481721974485 37.50332857770494, 126.8475190736759 37.50451037434537, 126.8473578029969 37.50481203979833, 126.8452943891224 37.50787100433432, 126.8471813344712 37.50879204972308, 126.8512431820223 37.51003012413108, 126.8529024426636 37.51057665595959, 126.8540242709842 37.51030337801248, 126.8550748626048 37.50992379177743, 126.8560858472955 37.50946851466372, 126.858155804753 37.50994514085227)))"
267,서울특별시,구로구,개봉2동,11530750,33428,16331,17097,"MULTIPOLYGON (((126.8641895705145 37.49400575957798, 126.8681934532679 37.49552577662323, 126.8683057762067 37.49510381307537, 126.8670398418023 37.49295518021014, 126.8630918813355 37.4909588204666, 126.861700811827 37.4907700000479, 126.8587379759727 37.49017032840003, 126.8554091193748 37.4899640557073, 126.8510204676571 37.48985113639938, 126.8509732260376 37.48985156190282, 126.8504742371653 37.48989646504405, 126.8481420307691 37.49045936414745, 126.8482853879582 37.4938852904773, 126.8486195356656 37.49521323350411, 126.8507652325259 37.49572756359746, 126.8532678049108 37.49585171004789, 126.8555064345336 37.49542340403423, 126.8561623979256 37.49527825777167, 126.8578545335713 37.49484242602497, 126.8583299648688 37.49449007924137, 126.8586165870534 37.49433500497385, 126.859289681221 37.49420071714838, 126.863191622053 37.49396207680955, 126.8641895705145 37.49400575957798)))"
268,서울특별시,구로구,개봉3동,11530760,22176,10857,11319,"MULTIPOLYGON (((126.8565091903402 37.48568638132199, 126.8534827885174 37.48263904302956, 126.8534484481019 37.48260505432254, 126.8532416306583 37.48240449770579, 126.8530778945039 37.48229205867379, 126.8525648754771 37.4819411003821, 126.8519762417528 37.48166972034969, 126.8518917476425 37.48163094932067, 126.8514948055381 37.48159159033234, 126.8510851401442 37.48155216013095, 126.8506316287498 37.48159586280539, 126.8500125634167 37.48165668014651, 126.8482413456716 37.48211111994312, 126.8481711711216 37.48221438852783, 126.8482696024101 37.48235689571379, 126.8498653635111 37.4838777090018, 126.8496660772664 37.48395210058439, 126.8475860931306 37.48462509845616, 126.8458075126013 37.485508166818, 126.8446554940932 37.48652594492546, 126.8450302373431 37.48711853563734, 126.8463693108368 37.48910429571718, 126.8471773343626 37.48984014834149, 126.8476196789332 37.49023679675214, 126.8479028518332 37.49035760191701, 126.8481420307691 37.49045936414745, 126.8504742371653 37.48989646504405, 126.8509732260376 37.48985156190282, 126.8510204676571 37.48985113639938, 126.8554091193748 37.4899640557073, 126.8587379759727 37.49017032840003, 126.861700811827 37.4907700000479, 126.8630918813355 37.4909588204666, 126.8618673455394 37.49039121447398, 126.8617209540776 37.49027066981233, 126.8616139205171 37.49018252949486, 126.8612556652883 37.48982568058405, 126.8590740059246 37.48733176129451, 126.8583375054177 37.48648725095271, 126.8581750804904 37.486301591112, 126.8577041675553 37.48589905606083, 126.8565091903402 37.48568638132199)))"
269,서울특별시,구로구,오류1동,11530770,23025,11297,11728,"MULTIPOLYGON (((126.8383636857055 37.50014195093869, 126.8387447468402 37.50022848626508, 126.8410894868935 37.50014131312201, 126.8413612405198 37.50011466142034, 126.8415587003251 37.50009435513614, 126.8433603990656 37.49984524557688, 126.844054446443 37.49971840562281, 126.8441480085367 37.49969301127203, 126.8447740252256 37.49940658185703, 126.8483763049321 37.49766245807698, 126.8487885514971 37.49741460623983, 126.8499566654245 37.49663184673621, 126.8500669252532 37.49651466022354, 126.8501711744606 37.49640345706568, 126.8503716563863 37.49618959626579, 126.8507652325259 37.49572756359746, 126.8486195356656 37.49521323350411, 126.8477848808612 37.4950159787009, 126.84555252134 37.49439747342128, 126.8450708489477 37.49401398274528, 126.8443477345605 37.49383195457469, 126.8441106593949 37.49377655742627, 126.8398069845272 37.49337852368655, 126.8380788216071 37.49316266899123, 126.8373685897365 37.49448705554278, 126.8368873092591 37.49619274794146, 126.8355961344367 37.49695356160746, 126.8344152697241 37.49767982533444, 126.8342703143852 37.49784068837145, 126.8341247176742 37.49831195037124, 126.8341232612406 37.49834053842368, 126.8341201068807 37.49843242599638, 126.8341261962766 37.49854292989821, 126.8341424047136 37.49862864960364, 126.8342409852816 37.49891425746907, 126.8353476612103 37.50001788409524, 126.8356898746465 37.50033866193461, 126.8358079502342 37.50041932077779, 126.8362186762076 37.50062950347331, 126.836377944616 37.50065011537944, 126.8364139985807 37.50065031882215, 126.8368887709668 37.50063044215423, 126.8383636857055 37.50014195093869)))"
270,서울특별시,구로구,오류2동,11530780,51567,25087,26480,"MULTIPOLYGON (((126.8481420307691 37.49045936414745, 126.8479028518332 37.49035760191701, 126.8476196789332 37.49023679675214, 126.8471773343626 37.48984014834149, 126.8463693108368 37.48910429571718, 126.8450302373431 37.48711853563734, 126.8446554940932 37.48652594492546, 126.8458075126013 37.485508166818, 126.8475860931306 37.48462509845616, 126.8496660772664 37.48395210058439, 126.8498653635111 37.4838777090018, 126.8482696024101 37.48235689571379, 126.8464839602125 37.48170481737114, 126.8460342111861 37.47969568892962, 126.845944634589 37.47821246494122, 126.8459415479134 37.47816174755872, 126.8458898817945 37.4774392511102, 126.8458161918114 37.476566781474, 126.8455505375182 37.47452935039667, 126.8455422688075 37.4743410755008, 126.8455392864279 37.47427351412865, 126.8454879841172 37.47408060494273, 126.8453278272608 37.47380367762621, 126.8450440704379 37.4738392859682, 126.8446185266647 37.47392918096103, 126.8441839875234 37.47402490132353, 126.8436067001447 37.4744294218989, 126.8435627174183 37.47454764264707, 126.8434681855148 37.47469213282304, 126.8432782412132 37.47482660768363, 126.8429128865272 37.47489781242167, 126.8427776786711 37.47492072099014, 126.8427083577518 37.47492709464169, 126.8425818528301 37.47492413834603, 126.8424386425753 37.47489292070365, 126.8423960419166 37.47487459341933, 126.8423675453067 37.47485872419847, 126.8422780823776 37.47482442541774, 126.842168814397 37.47480005649873, 126.8420642000183 37.47479056051066, 126.8419678172169 37.47481931690672, 126.8418673910643 37.47482551863165, 126.8417439620763 37.4747955361223, 126.8414107444378 37.47470730331786, 126.8410075971545 37.47461566364108, 126.8408456040556 37.47462941156338, 126.8401293050812 37.47474033611127, 126.8399967116256 37.4747880433544, 126.8397757476786 37.47499750055211, 126.8397360652216 37.47505247687452, 126.8388414268117 37.47546435970531, 126.8384781664109 37.47537669774958, 126.837330976592 37.47513366461288, 126.8371313264782 37.47509941001061, 126.8369032761284 37.47506028340772, 126.8368496282256 37.47505209456342, 126.8357925015464 37.47525684918626, 126.8334085177002 37.47690416889068, 126.8317936893084 37.47757456016188, 126.8296463413941 37.47669358034054, 126.8292806526969 37.47624760704491, 126.828760308999 37.47610043541639, 126.82196187862 37.47554108554455, 126.8197138471906 37.47798660546205, 126.8195678101004 37.48027634637437, 126.8194233251638 37.48396374054159, 126.8193892096795 37.48536998719101, 126.819433860404 37.48547008179098, 126.8195081228307 37.48555792810607, 126.8203676090682 37.48587945838577, 126.8211922472845 37.48615460502872, 126.8212641383274 37.48617867856536, 126.8212960907439 37.48619012001911, 126.8223280040659 37.48673686309676, 126.8231856986221 37.48750229659552, 126.8233332953559 37.48821757534788, 126.8231721197619 37.48854894900699, 126.8238570835715 37.48878267990725, 126.8240516095935 37.48884914198792, 126.8249872443651 37.48955605800926, 126.8264096262804 37.49063151238221, 126.8270237429272 37.49121187746591, 126.8268451539266 37.49125930764014, 126.8268120267852 37.49227201278824, 126.8267857274629 37.49315406070477, 126.8269360469714 37.49320674494209, 126.8315642099405 37.49322062930847, 126.8322355111816 37.49322217150804, 126.8325006949198 37.49321042030817, 126.8325012556284 37.49307382362407, 126.8331488690006 37.49307522768298, 126.8333597804692 37.49307582316049, 126.8343493506773 37.49307861802059, 126.8343846996712 37.49307881719488, 126.8358961631116 37.49309408469683, 126.8364361764443 37.49311063946205, 126.8380788216071 37.49316266899123, 126.8398069845272 37.49337852368655, 126.8441106593949 37.49377655742627, 126.8443477345605 37.49383195457469, 126.8450708489477 37.49401398274528, 126.84555252134 37.49439747342128, 126.8477848808612 37.4950159787009, 126.8486195356656 37.49521323350411, 126.8482853879582 37.4938852904773, 126.8481420307691 37.49045936414745)))"
271,서울특별시,구로구,수궁동,11530790,25000,12417,12583,"MULTIPOLYGON (((126.8364139985807 37.50065031882215, 126.836377944616 37.50065011537944, 126.8362186762076 37.50062950347331, 126.8358079502342 37.50041932077779, 126.8356898746465 37.50033866193461, 126.8353476612103 37.50001788409524, 126.8342409852816 37.49891425746907, 126.8341424047136 37.49862864960364, 126.8341261962766 37.49854292989821, 126.8341201068807 37.49843242599638, 126.8341232612406 37.49834053842368, 126.8341247176742 37.49831195037124, 126.8342703143852 37.49784068837145, 126.8344152697241 37.49767982533444, 126.8355961344367 37.49695356160746, 126.8368873092591 37.49619274794146, 126.8373685897365 37.49448705554278, 126.8380788216071 37.49316266899123, 126.8364361764443 37.49311063946205, 126.8358961631116 37.49309408469683, 126.8343846996712 37.49307881719488, 126.8343493506773 37.49307861802059, 126.8333597804692 37.49307582316049, 126.8331488690006 37.49307522768298, 126.8325012556284 37.49307382362407, 126.8325006949198 37.49321042030817, 126.8322355111816 37.49322217150804, 126.8315642099405 37.49322062930847, 126.8269360469714 37.49320674494209, 126.8267857274629 37.49315406070477, 126.8268120267852 37.49227201278824, 126.8268451539266 37.49125930764014, 126.8270237429272 37.49121187746591, 126.8264096262804 37.49063151238221, 126.8249872443651 37.48955605800926, 126.8240516095935 37.48884914198792, 126.8238570835715 37.48878267990725, 126.8231721197619 37.48854894900699, 126.8206037442479 37.49062616196878, 126.820562577511 37.49065207793016, 126.8202590079385 37.49084302796498, 126.8202052779746 37.49087443465385, 126.8194119228185 37.49124375907626, 126.8185428866468 37.49164773659464, 126.8178578667784 37.49158370808227, 126.8143920517142 37.49319883168194, 126.8127224595087 37.49616584119955, 126.8126687240236 37.49662859635275, 126.8130919642608 37.49802056692818, 126.8134849871964 37.49806085618096, 126.8142338832979 37.49780610125649, 126.8156299037984 37.49755164649594, 126.8159267732337 37.49764012095871, 126.8165070935091 37.49781361175107, 126.8187442039848 37.49875041842893, 126.8193222282364 37.49927535106065, 126.8193472730852 37.49929918285351, 126.8215941436919 37.50206125263034, 126.8218901353554 37.50263981605466, 126.8225438429961 37.50401023842629, 126.8229615457098 37.50582885608983, 126.8247949083413 37.50829216307102, 126.8248500075126 37.50822147605434, 126.8291976060468 37.5086180529486, 126.8306750051046 37.5075729819132, 126.8306426973103 37.50683481893005, 126.8326423018806 37.50503104014351, 126.8338768789597 37.50408370435296, 126.8342407558259 37.50383408979962, 126.8343379000366 37.50376745063463, 126.8353480513325 37.50348358006146, 126.8356961108277 37.50338638945685, 126.8361715407997 37.50303866226452, 126.8364178026688 37.502457548209, 126.8365264323814 37.50096980320156, 126.8364565639848 37.50077126682277, 126.8364139985807 37.50065031882215)))"
272,서울특별시,구로구,가리봉동,11530595,15518,8946,6572,"MULTIPOLYGON (((126.8860530654307 37.48498340675444, 126.8862101317963 37.48497539317863, 126.8865869922807 37.48495616409854, 126.8875114192476 37.48483938982995, 126.8879088111987 37.48474230022049, 126.8879727440702 37.48472515504731, 126.8880448875197 37.48470579807772, 126.8909892011053 37.48390535901134, 126.8910347328456 37.4838908980017, 126.8912530434299 37.48381991458385, 126.8913012771906 37.48379988259234, 126.8915566475545 37.48369190861108, 126.8914259870203 37.483501950917, 126.8913286936279 37.48338314675793, 126.8921115052932 37.48064902391688, 126.8934755917505 37.48025403031156, 126.8943814331967 37.4802012741004, 126.8960483773837 37.47878566328195, 126.8961675538531 37.4785531130379, 126.8958630028599 37.47845572032971, 126.8955979010521 37.47845774369489, 126.8955576071532 37.47845866426201, 126.8953746242434 37.47846674158331, 126.895214642815 37.47847380966519, 126.8948078822895 37.47851228793096, 126.8944136151686 37.47857786953251, 126.8904092712932 37.47925808212584, 126.8901983165133 37.47929530118238, 126.8901310586557 37.47930734768259, 126.8899282748655 37.47934878441654, 126.88974650064 37.47939662619434, 126.8895190698095 37.4794596720291, 126.8893007245197 37.47953628653424, 126.88907734584 37.47962413975885, 126.8887169367367 37.4797991010174, 126.8885314944726 37.47989961071983, 126.8884517743216 37.47994882679053, 126.888339667949 37.48001804750164, 126.8882186988783 37.48009916518436, 126.8881612677389 37.48013767929015, 126.8879015164848 37.48034615248518, 126.8878389197016 37.4803974028732, 126.8877477138769 37.48047699324167, 126.8876259812272 37.48059121856875, 126.8875672273615 37.48065313464456, 126.8874962089827 37.48072800269208, 126.88737275202 37.48087295865968, 126.8871806712161 37.48110606182217, 126.8854677536213 37.48284241412711, 126.8822714314003 37.48502956123892, 126.8806588579626 37.48596867912071, 126.8801534881763 37.48734399127603, 126.8828770649042 37.48660333583112, 126.885944161247 37.48498896368334, 126.8860530654307 37.48498340675444)))"
273,서울특별시,구로구,구로2동,11530530,35481,18595,16886,"MULTIPOLYGON (((126.8812327309338 37.503993114705, 126.8798204004839 37.5030158042717, 126.8808225887396 37.50202601629196, 126.8834692685017 37.49970422987348, 126.8835027588026 37.49967496646821, 126.8835269506418 37.49965382980053, 126.8835630756388 37.4996260944005, 126.8836173256747 37.49958444653796, 126.8837482188059 37.49948823399233, 126.8838512534132 37.49942567673734, 126.8839840958764 37.49935031788475, 126.8840650425473 37.49930961573805, 126.8841246389351 37.49928226393529, 126.8841573111998 37.49926728342493, 126.8843393929986 37.49919187890455, 126.8843722801954 37.49917826860986, 126.8846957001031 37.49905714338698, 126.8872233339024 37.49717293305375, 126.8888188721015 37.49528600134448, 126.8904108206446 37.49320710509139, 126.8896594878419 37.49209064075185, 126.8879880121088 37.48992933244972, 126.8860412623091 37.49016101979674, 126.8855203904895 37.49024349964461, 126.8852020989526 37.4903301665092, 126.8848103440478 37.4904201374269, 126.8841898945114 37.49056262688062, 126.8841160526165 37.49053343465913, 126.8840715431571 37.49051573346122, 126.8844447359265 37.48892968729761, 126.884809874817 37.48789672031732, 126.8855244187719 37.48619575116335, 126.8855683935121 37.48609119732843, 126.8860530654307 37.48498340675444, 126.885944161247 37.48498896368334, 126.8828770649042 37.48660333583112, 126.8801534881763 37.48734399127603, 126.880133840495 37.48740132161623, 126.880008750391 37.48850820571184, 126.8799152338324 37.48990030761533, 126.8798200386677 37.49132394769115, 126.8799807509791 37.49215291036344, 126.8799858386903 37.49222166531193, 126.8800046359618 37.49251357733046, 126.8798513263894 37.49463771341576, 126.879592563895 37.4970294482552, 126.8795832966547 37.49712404168102, 126.8795804795971 37.49717725179757, 126.8795732370908 37.497314399728, 126.8795688896198 37.49749802761907, 126.8795656067499 37.49772321347823, 126.8795713070843 37.49780337371575, 126.8795791975007 37.49790652094666, 126.8795915521369 37.49806558453007, 126.8796119688945 37.49827341759832, 126.8796350259335 37.49843465555347, 126.8796718230644 37.49864441338096, 126.8796806474222 37.49868952737262, 126.8797132432808 37.49885194208328, 126.8797365557593 37.49893994641306, 126.8797701607482 37.49906518558935, 126.8798656992226 37.49939693439133, 126.8801243897364 37.50000783205674, 126.8801641137406 37.50008397948085, 126.8783484224009 37.499810341945, 126.8750968434927 37.49866917087664, 126.8733200269927 37.49799120766659, 126.8729100043639 37.4978132679779, 126.8718327033247 37.49727574606308, 126.8712060398487 37.49696369871408, 126.8684107676805 37.49644283046339, 126.8680284188128 37.49706166449341, 126.8712606761671 37.50562598499916, 126.8734788432939 37.50852330999402, 126.8770291753663 37.50549696436072, 126.8775379280143 37.50528291632785, 126.8777742305242 37.505183885912, 126.8781351997857 37.50503741525818, 126.8783361689954 37.50495587320219, 126.8784163363035 37.50492362107256, 126.8801360636838 37.50493158546576, 126.8812327309338 37.503993114705)))"
274,서울특별시,구로구,개봉1동,11530740,34177,17149,17028,"MULTIPOLYGON (((126.8560453119274 37.50224394455856, 126.8558212327698 37.50116560682152, 126.8558003883705 37.50104043151453, 126.8556262994431 37.49998828058906, 126.8555515347732 37.49930847879986, 126.8566406434254 37.49755227123239, 126.8604986100101 37.49685889760952, 126.8625603083034 37.49661766185834, 126.862836607115 37.49671942792459, 126.8630995537794 37.49681098114218, 126.8636083020224 37.49610052764123, 126.8641106993599 37.49479174212108, 126.8641895705145 37.49400575957798, 126.863191622053 37.49396207680955, 126.859289681221 37.49420071714838, 126.8586165870534 37.49433500497385, 126.8583299648688 37.49449007924137, 126.8578545335713 37.49484242602497, 126.8561623979256 37.49527825777167, 126.8555064345336 37.49542340403423, 126.8532678049108 37.49585171004789, 126.8507652325259 37.49572756359746, 126.8503716563863 37.49618959626579, 126.8501711744606 37.49640345706568, 126.8500669252532 37.49651466022354, 126.8499566654245 37.49663184673621, 126.8487885514971 37.49741460623983, 126.8483763049321 37.49766245807698, 126.8447740252256 37.49940658185703, 126.8441480085367 37.49969301127203, 126.844054446443 37.49971840562281, 126.8433603990656 37.49984524557688, 126.8415587003251 37.50009435513614, 126.8413612405198 37.50011466142034, 126.8410894868935 37.50014131312201, 126.8387447468402 37.50022848626508, 126.8383636857055 37.50014195093869, 126.8383816221437 37.50147482480303, 126.8389828050208 37.5029011978253, 126.840617935427 37.5039930839468, 126.8423284007361 37.50488594311254, 126.8445383266275 37.50643848308649, 126.8452943891224 37.50787100433432, 126.8473578029969 37.50481203979833, 126.8475190736759 37.50451037434537, 126.8481721974485 37.50332857770494, 126.8482682974815 37.5031736249253, 126.8484432622137 37.50289404464481, 126.8499768039879 37.50132400130452, 126.8524583372303 37.49965633052552, 126.852739435186 37.49947900685162, 126.8528254902116 37.49950313882419, 126.8529177976704 37.49954082525959, 126.8530051599811 37.49957735784857, 126.8535347924571 37.5006359250533, 126.8546271996157 37.50261022552576, 126.8546836217226 37.50259726047348, 126.8549850510626 37.50252771806726, 126.8560453119274 37.50224394455856)))"
275,서울특별시,금천구,가산동,11545510,24497,13739,10758,"MULTIPOLYGON (((126.8806588579626 37.48596867912071, 126.8822714314003 37.48502956123892, 126.8854677536213 37.48284241412711, 126.8871806712161 37.48110606182217, 126.88737275202 37.48087295865968, 126.8874962089827 37.48072800269208, 126.8875672273615 37.48065313464456, 126.8876259812272 37.48059121856875, 126.8877477138769 37.48047699324167, 126.8878389197016 37.4803974028732, 126.8879015164848 37.48034615248518, 126.8881612677389 37.48013767929015, 126.8882186988783 37.48009916518436, 126.888339667949 37.48001804750164, 126.8884517743216 37.47994882679053, 126.8885314944726 37.47989961071983, 126.8887169367367 37.4797991010174, 126.88907734584 37.47962413975885, 126.8893007245197 37.47953628653424, 126.8895190698095 37.4794596720291, 126.88974650064 37.47939662619434, 126.8899282748655 37.47934878441654, 126.8901310586557 37.47930734768259, 126.8901983165133 37.47929530118238, 126.8904092712932 37.47925808212584, 126.8944136151686 37.47857786953251, 126.8948078822895 37.47851228793096, 126.895214642815 37.47847380966519, 126.8953746242434 37.47846674158331, 126.8955576071532 37.47845866426201, 126.8955979010521 37.47845774369489, 126.8958630028599 37.47845572032971, 126.8965252568705 37.47575063401164, 126.8959104384459 37.47546007644407, 126.8956795079376 37.47534622588471, 126.8949853251686 37.47500241098335, 126.894700250847 37.47485448035702, 126.8940576051923 37.47451881089277, 126.8940049426824 37.47351240059041, 126.8938782346242 37.4722263119974, 126.8927880306827 37.47225777293988, 126.8922669119171 37.47228213451401, 126.8918693940569 37.47230186606518, 126.8901707690446 37.47224654736071, 126.887119888821 37.47202914733683, 126.8882949407654 37.46933166452317, 126.8891048328142 37.46756299582083, 126.889400659852 37.46575583668659, 126.8867671332615 37.46467771640881, 126.8860657480956 37.4654820070775, 126.8857818084842 37.46581618384113, 126.8806544941702 37.47185013170166, 126.8798957999536 37.47278197291326, 126.8798619454203 37.47282609783342, 126.8797607800107 37.4729587044691, 126.8794989475866 37.4733019112929, 126.8791666548374 37.47373845056003, 126.8790079452768 37.47395506886748, 126.8784603181344 37.47470256889289, 126.8781461462441 37.47517630119928, 126.8779785973388 37.4754290051067, 126.877821116907 37.47566703541882, 126.8775846701186 37.47605111996899, 126.8766574516259 37.47756163707638, 126.8766440398023 37.47758593448088, 126.8762992927034 37.47821435681261, 126.8761337446439 37.47851675753803, 126.87572481134 37.47928700998089, 126.875621456338 37.47948168848855, 126.8751567770089 37.48044593590276, 126.8747168506631 37.48140805890412, 126.873909017617 37.48333383210486, 126.8739774192049 37.48505125149168, 126.8747424680725 37.48538205210301, 126.8753222561957 37.48544820493883, 126.8755186414189 37.4854779062331, 126.8763410627301 37.48560569105042, 126.8770842379146 37.48583831978431, 126.8773709825015 37.48595927254647, 126.8781020277769 37.48629324420081, 126.8806588579626 37.48596867912071)))"
276,서울특별시,금천구,독산1동,11545610,43529,22633,20896,"MULTIPOLYGON (((126.8980103686118 37.47142257136419, 126.8976313344687 37.46651274441574, 126.8973234557303 37.46357274355732, 126.8973303915126 37.46350179689762, 126.8973780546233 37.46302833155168, 126.8974171521459 37.46264144219538, 126.8977030214221 37.46171675283374, 126.8978067357797 37.46145431879469, 126.8980629826591 37.46080596043571, 126.8987436056722 37.45939317835395, 126.8974025139834 37.45900550841061, 126.8973016072001 37.45897615030189, 126.8968152139542 37.45883463388245, 126.8931043469589 37.45736442810479, 126.8935415149126 37.45598197519222, 126.893800442439 37.45541130050166, 126.8940285962284 37.45490847591982, 126.8946606325501 37.45391928120703, 126.8948559254214 37.45361362861721, 126.8952320961818 37.45277980003716, 126.8944639334077 37.45253674912424, 126.8940737618458 37.45263950724652, 126.892628850394 37.45191891378064, 126.8924626398266 37.45193833916714, 126.8897071980899 37.45232412348744, 126.8896228642902 37.45235072425987, 126.8895264602269 37.4525273968299, 126.8894811166427 37.45275345995212, 126.8871700181657 37.45557166172729, 126.8863790852839 37.45619850941883, 126.8862021867816 37.45657278264891, 126.8852740259245 37.4600618517056, 126.8860552234428 37.46064283230479, 126.8866739843578 37.46097668643171, 126.8876186483499 37.46112974200616, 126.8879765499143 37.46100653259413, 126.8882247709433 37.46089965480682, 126.8883921265525 37.46082953905925, 126.8885985353728 37.46083330223453, 126.8886507452381 37.46083425738268, 126.8886794219396 37.46084648394887, 126.8888620259499 37.46092435945716, 126.8889556306652 37.46105892068607, 126.8890657195399 37.46125215540604, 126.8890998898233 37.46139542282006, 126.8890846377404 37.46153280123432, 126.888650115574 37.46247360090581, 126.8867671332615 37.46467771640881, 126.889400659852 37.46575583668659, 126.8891048328142 37.46756299582083, 126.8882949407654 37.46933166452317, 126.887119888821 37.47202914733683, 126.8901707690446 37.47224654736071, 126.8918693940569 37.47230186606518, 126.8922669119171 37.47228213451401, 126.8927880306827 37.47225777293988, 126.8938782346242 37.4722263119974, 126.8940049426824 37.47351240059041, 126.8940576051923 37.47451881089277, 126.894700250847 37.47485448035702, 126.8949853251686 37.47500241098335, 126.8956795079376 37.47534622588471, 126.8959104384459 37.47546007644407, 126.8965252568705 37.47575063401164, 126.8958630028599 37.47845572032971, 126.8961675538531 37.4785531130379, 126.8989530177933 37.47895367065259, 126.8980103686118 37.47142257136419)))"
277,서울특별시,금천구,독산2동,11545620,21602,11101,10501,"MULTIPOLYGON (((126.9123996033828 37.46601023914257, 126.9124361728704 37.46567691438344, 126.9109640082317 37.46525775486387, 126.9107230003625 37.46540249776157, 126.9102465541583 37.46559615209073, 126.9099310726425 37.46572076745144, 126.9096657753501 37.46566423411658, 126.9072792407091 37.46445156765383, 126.9049172049723 37.46270311091959, 126.9043649614755 37.46229358918919, 126.9028985077165 37.46220393936445, 126.9025609579875 37.46163775771323, 126.9025391880284 37.46135134606738, 126.9024809803993 37.46058614254392, 126.9018116675291 37.45943802300374, 126.9001448649335 37.45816316855686, 126.9001040194468 37.45815283714077, 126.8993669418622 37.45796880402646, 126.8991234509928 37.45845993412783, 126.898870428426 37.45908058567532, 126.8987436056722 37.45939317835395, 126.8980629826591 37.46080596043571, 126.8978067357797 37.46145431879469, 126.8977030214221 37.46171675283374, 126.8974171521459 37.46264144219538, 126.8973780546233 37.46302833155168, 126.8973303915126 37.46350179689762, 126.8973234557303 37.46357274355732, 126.8976313344687 37.46651274441574, 126.8999370497741 37.46648278879391, 126.9008785511931 37.46647179236997, 126.9017069383896 37.4664647225722, 126.9017447669223 37.46646712152724, 126.9024331819863 37.46655288993568, 126.9028105063096 37.46660325453733, 126.9036407553513 37.46671786405387, 126.9043241566037 37.4668125736882, 126.9053178572011 37.46699334381503, 126.9059669642291 37.46722532860692, 126.9063004743163 37.46732502753774, 126.9063707488429 37.46734595862628, 126.9064351568816 37.46736513860897, 126.9066355703944 37.46740445291603, 126.9067824760195 37.4674175842007, 126.9074274926837 37.46736223227013, 126.9077274825366 37.46732204842956, 126.9078422244193 37.46729107592601, 126.9080773796425 37.46722690559577, 126.9081237432176 37.46716389848457, 126.9123996033828 37.46601023914257)))"
278,서울특별시,금천구,독산3동,11545630,30152,15594,14558,"MULTIPOLYGON (((126.9082284708289 37.47262567309232, 126.9073618025177 37.47228106665835, 126.9065957471872 37.47206314936151, 126.9063215751595 37.47198515667845, 126.9049058989313 37.47215380012722, 126.9044530959521 37.47220898035157, 126.9036288621593 37.47230735264137, 126.9031895076808 37.47235921670002, 126.9004492335702 37.47128850081825, 126.8980103686118 37.47142257136419, 126.8989530177933 37.47895367065259, 126.899468525752 37.48034441659667, 126.9006741413445 37.47932637164095, 126.9021187151585 37.47954212836024, 126.9024723447659 37.47960701229682, 126.9038607795251 37.47986189908314, 126.9053094415572 37.48012800529317, 126.9065515927928 37.48035656974228, 126.907497403291 37.48053142251079, 126.9085463260537 37.48072596301455, 126.9097237213896 37.48094931346144, 126.9088228423749 37.47944264349188, 126.9088243242033 37.47886491694283, 126.9092400452775 37.47839615513239, 126.9094851576208 37.47820235192579, 126.9106484845194 37.47810087632084, 126.911259169081 37.47814360313711, 126.9112916399684 37.47814939841609, 126.9116216363534 37.47816569016155, 126.9118633852895 37.47726328185676, 126.9119375780869 37.4769053614489, 126.9116395510558 37.4755191667737, 126.9113468021257 37.47473606001092, 126.9109577528336 37.47385727094998, 126.9109340131264 37.47381997157465, 126.910907456927 37.47379137879275, 126.9108723268727 37.47375431555722, 126.9108484899583 37.47372940935475, 126.9108098511298 37.47369992254787, 126.9107212565329 37.47363976575863, 126.9098816980279 37.47326038535456, 126.9098443469567 37.47324555173434, 126.9082284708289 37.47262567309232)))"
279,서울특별시,금천구,독산4동,11545640,18444,9400,9044,"MULTIPOLYGON (((126.9123996033828 37.46601023914257, 126.9081237432176 37.46716389848457, 126.9080773796425 37.46722690559577, 126.9078422244193 37.46729107592601, 126.9077274825366 37.46732204842956, 126.9074274926837 37.46736223227013, 126.9067824760195 37.4674175842007, 126.9066355703944 37.46740445291603, 126.9064351568816 37.46736513860897, 126.9063707488429 37.46734595862628, 126.9063004743163 37.46732502753774, 126.9059669642291 37.46722532860692, 126.9053178572011 37.46699334381503, 126.9043241566037 37.4668125736882, 126.9036407553513 37.46671786405387, 126.9028105063096 37.46660325453733, 126.9024331819863 37.46655288993568, 126.9017447669223 37.46646712152724, 126.9017069383896 37.4664647225722, 126.9008785511931 37.46647179236997, 126.8999370497741 37.46648278879391, 126.8976313344687 37.46651274441574, 126.8980103686118 37.47142257136419, 126.9004492335702 37.47128850081825, 126.9031895076808 37.47235921670002, 126.9036288621593 37.47230735264137, 126.9044530959521 37.47220898035157, 126.9049058989313 37.47215380012722, 126.9063215751595 37.47198515667845, 126.9065957471872 37.47206314936151, 126.9073618025177 37.47228106665835, 126.9082284708289 37.47262567309232, 126.9086356383151 37.4720835165265, 126.9090072091013 37.47121331130845, 126.9101252449177 37.46907253761359, 126.911617354111 37.46662715342153, 126.9118639490203 37.466415624186, 126.9123996033828 37.46601023914257)))"
280,서울특별시,금천구,시흥1동,11545670,37034,18627,18407,"MULTIPOLYGON (((126.9061310852559 37.45371251385107, 126.9059264723362 37.45090374436197, 126.9057596706704 37.45010407415685, 126.9057038431784 37.44983676507264, 126.9056863803695 37.44981188981448, 126.9053759085106 37.44939908189373, 126.9048895414507 37.44907101872368, 126.9047496593978 37.44897792470202, 126.9041066400542 37.44880117218764, 126.9038051274479 37.44873035397363, 126.9029205790294 37.44852031942307, 126.9033218583548 37.44743502973719, 126.9033946759686 37.44725287066579, 126.9034408148831 37.44713705412491, 126.9035723895845 37.4464887420929, 126.9034927508208 37.4463389457286, 126.900656175758 37.44447634053677, 126.900273990566 37.44433819790273, 126.8997673094288 37.44434732996411, 126.8994854077164 37.44438927512371, 126.8993467476242 37.44441110457046, 126.8982256161847 37.44465436493447, 126.8961231885118 37.44584699830896, 126.8950916430823 37.44842547508821, 126.8948266127331 37.45084855441404, 126.8940737618458 37.45263950724652, 126.8944639334077 37.45253674912424, 126.8952320961818 37.45277980003716, 126.8948559254214 37.45361362861721, 126.8946606325501 37.45391928120703, 126.8940285962284 37.45490847591982, 126.893800442439 37.45541130050166, 126.8935415149126 37.45598197519222, 126.8931043469589 37.45736442810479, 126.8968152139542 37.45883463388245, 126.8973016072001 37.45897615030189, 126.8974025139834 37.45900550841061, 126.8987436056722 37.45939317835395, 126.898870428426 37.45908058567532, 126.8991234509928 37.45845993412783, 126.8993669418622 37.45796880402646, 126.9001040194468 37.45815283714077, 126.9001448649335 37.45816316855686, 126.9018116675291 37.45943802300374, 126.9024809803993 37.46058614254392, 126.9025391880284 37.46135134606738, 126.9025609579875 37.46163775771323, 126.9028985077165 37.46220393936445, 126.9043649614755 37.46229358918919, 126.9046083634661 37.46154443475024, 126.9060255053972 37.45455174789363, 126.9061310852559 37.45371251385107)))"
281,서울특별시,금천구,시흥2동,11545680,22735,11055,11680,"MULTIPOLYGON (((126.9287494338708 37.45019265142709, 126.9283398395378 37.44968928439697, 126.9253526424637 37.44751828653838, 126.9237306576769 37.44664508071529, 126.9221239307993 37.44517026747464, 126.9210933163163 37.44412527627808, 126.9164523913576 37.44646321165788, 126.9126283197994 37.44843033098229, 126.9124629194611 37.44853874581019, 126.9123247150792 37.44894259806175, 126.912230318635 37.44935788184274, 126.9122252879753 37.4493982919197, 126.9122107134027 37.44951552267403, 126.9122101448745 37.44967776498807, 126.9126212108402 37.45087636652573, 126.9126301882726 37.4509023252936, 126.9137280490141 37.45292344739652, 126.9139407448734 37.45314245876293, 126.9141370203189 37.45321729039532, 126.9142382476885 37.45319525813882, 126.9145603139396 37.45312474511274, 126.9145975564519 37.45310738009093, 126.9146872601273 37.45306678541434, 126.9148364649819 37.45308614641819, 126.9149399822059 37.4530995844577, 126.9150012852731 37.45312129526294, 126.9153666382932 37.45330112211244, 126.9164527663339 37.45384392695598, 126.9181852311503 37.45551660729634, 126.9182988068485 37.45599826795386, 126.9184451949495 37.45680570664081, 126.9184469658929 37.45694204621612, 126.918410725052 37.45716267788382, 126.9224684372865 37.4572479499552, 126.9225089097932 37.45694731844073, 126.9224300064835 37.45673173284288, 126.9226384280472 37.45554295431342, 126.9230559836039 37.45463461842495, 126.9231840567649 37.45442793043426, 126.9253017306146 37.45288001830183, 126.9270717555706 37.45168980086971, 126.9287494338708 37.45019265142709)))"
282,서울특별시,금천구,시흥3동,11545690,11598,5808,5790,"MULTIPOLYGON (((126.9152195932067 37.44005599984209, 126.914874986456 37.44008861827828, 126.9148010255342 37.44009561624853, 126.9143330372052 37.44003921643165, 126.9141194145311 37.43989055945078, 126.9140273770294 37.43982362763839, 126.9123569392102 37.43858947998881, 126.9113453731598 37.43754350392285, 126.91131521914 37.43749078981877, 126.9112494669302 37.43737501565715, 126.9108203430554 37.43659995706249, 126.9104709929515 37.43565403740469, 126.9103810826499 37.43540909396395, 126.9093354152024 37.43415999085182, 126.909114193235 37.4339921328092, 126.9089330751647 37.43391069849034, 126.9087340483729 37.43382122608362, 126.9082934119757 37.43370747639874, 126.9082038669879 37.43368449400618, 126.9073942449374 37.43359818914163, 126.9072376966521 37.43359339310883, 126.9044693943232 37.43405783101786, 126.9027902322366 37.43551299881972, 126.9019218564752 37.43637048559158, 126.9004909888613 37.43736038439733, 126.8993841287974 37.43814344432398, 126.8993443774076 37.43819078922225, 126.8991137962915 37.43846543430848, 126.8990771524036 37.43851867179782, 126.8990566116295 37.43854851965681, 126.8989444161929 37.43871349800082, 126.8988828777224 37.43880452466166, 126.898777271237 37.43911157762231, 126.8987227042759 37.43930959987991, 126.898796419602 37.43936743674205, 126.8990985529391 37.43960061891941, 126.8991165104391 37.44104109237652, 126.8989270473167 37.44238090575873, 126.8985110178103 37.44386603705051, 126.8982256161847 37.44465436493447, 126.8993467476242 37.44441110457046, 126.8994854077164 37.44438927512371, 126.8997673094288 37.44434732996411, 126.900273990566 37.44433819790273, 126.900656175758 37.44447634053677, 126.9034927508208 37.4463389457286, 126.9035723895845 37.4464887420929, 126.9034408148831 37.44713705412491, 126.9033946759686 37.44725287066579, 126.9033218583548 37.44743502973719, 126.9058610570994 37.4463909028479, 126.9072143576949 37.44583554480116, 126.9135103373139 37.44188969280247, 126.9152195932067 37.44005599984209)))"
283,서울특별시,금천구,시흥4동,11545700,22246,11077,11169,"MULTIPOLYGON (((126.9124361728704 37.46567691438344, 126.9137488246472 37.4652823290543, 126.9134807289906 37.46495763590994, 126.913030632375 37.46440106482278, 126.9128594085021 37.46397432171825, 126.9139625782421 37.45864492988382, 126.9141512833226 37.45809259685306, 126.9132286392321 37.45805534493142, 126.9104506644701 37.45670299916071, 126.9098749943082 37.45611418550637, 126.909686203758 37.45565746680174, 126.9096806783555 37.45559875610139, 126.9096425779431 37.45539987879366, 126.9091191392835 37.45393818467002, 126.9088278208045 37.45324267966844, 126.9061310852559 37.45371251385107, 126.9060255053972 37.45455174789363, 126.9046083634661 37.46154443475024, 126.9043649614755 37.46229358918919, 126.9049172049723 37.46270311091959, 126.9072792407091 37.46445156765383, 126.9096657753501 37.46566423411658, 126.9099310726425 37.46572076745144, 126.9102465541583 37.46559615209073, 126.9107230003625 37.46540249776157, 126.9109640082317 37.46525775486387, 126.9124361728704 37.46567691438344)))"
284,서울특별시,금천구,시흥5동,11545710,21031,10476,10555,"MULTIPOLYGON (((126.918410725052 37.45716267788382, 126.9184469658929 37.45694204621612, 126.9184451949495 37.45680570664081, 126.9182988068485 37.45599826795386, 126.9181852311503 37.45551660729634, 126.9164527663339 37.45384392695598, 126.9153666382932 37.45330112211244, 126.9150012852731 37.45312129526294, 126.9149399822059 37.4530995844577, 126.9148364649819 37.45308614641819, 126.9146872601273 37.45306678541434, 126.9145975564519 37.45310738009093, 126.9145603139396 37.45312474511274, 126.9142382476885 37.45319525813882, 126.9141370203189 37.45321729039532, 126.9139407448734 37.45314245876293, 126.9137280490141 37.45292344739652, 126.9126301882726 37.4509023252936, 126.9126212108402 37.45087636652573, 126.9122101448745 37.44967776498807, 126.9122107134027 37.44951552267403, 126.9122252879753 37.4493982919197, 126.912230318635 37.44935788184274, 126.9123247150792 37.44894259806175, 126.9124629194611 37.44853874581019, 126.9126283197994 37.44843033098229, 126.9164523913576 37.44646321165788, 126.9210933163163 37.44412527627808, 126.9209601255991 37.44362324057863, 126.9199285247661 37.44133885960424, 126.9198985160391 37.44129139074022, 126.9195126298456 37.44084895474003, 126.9194291278418 37.44077530881788, 126.9181081977579 37.43991815113953, 126.9180546964123 37.439893100232, 126.917952918151 37.43989823259329, 126.9152195932067 37.44005599984209, 126.9135103373139 37.44188969280247, 126.9072143576949 37.44583554480116, 126.9058610570994 37.4463909028479, 126.9033218583548 37.44743502973719, 126.9029205790294 37.44852031942307, 126.9038051274479 37.44873035397363, 126.9041066400542 37.44880117218764, 126.9047496593978 37.44897792470202, 126.9048895414507 37.44907101872368, 126.9053759085106 37.44939908189373, 126.9056863803695 37.44981188981448, 126.9057038431784 37.44983676507264, 126.9057596706704 37.45010407415685, 126.9059264723362 37.45090374436197, 126.9061310852559 37.45371251385107, 126.9088278208045 37.45324267966844, 126.9091191392835 37.45393818467002, 126.9096425779431 37.45539987879366, 126.9096806783555 37.45559875610139, 126.909686203758 37.45565746680174, 126.9098749943082 37.45611418550637, 126.9104506644701 37.45670299916071, 126.9132286392321 37.45805534493142, 126.9141512833226 37.45809259685306, 126.9148338641404 37.45766757101352, 126.918410725052 37.45716267788382)))"
285,서울특별시,영등포구,여의동,11560540,34576,16312,18264,"MULTIPOLYGON (((126.91451019651 37.54015593272531, 126.9254654174898 37.53782230476658, 126.9256461421733 37.53778037073113, 126.9279153706955 37.53725620986841, 126.9286283053523 37.53709178525238, 126.9288907524668 37.53703161884063, 126.9292299623807 37.53695385900097, 126.9296652962672 37.53689705915932, 126.9312332668581 37.53669424662898, 126.9340062933555 37.5363358075863, 126.9370875824056 37.53430558366682, 126.9435704355748 37.52941828315847, 126.9463376417002 37.52733348001347, 126.9467095221252 37.52705008388215, 126.947419988147 37.52585911923523, 126.9477164998475 37.52536025593309, 126.9479410860183 37.52358226240619, 126.9496153697221 37.52116318540098, 126.9504023930373 37.52002668967632, 126.9456341858428 37.51866246584442, 126.942963174707 37.51776431964156, 126.9396322016647 37.51700745173675, 126.9384822055998 37.51678990985248, 126.933038657393 37.51576455353615, 126.9321534490204 37.51565431547159, 126.9260111646754 37.51609788418517, 126.9252496564032 37.51623731486038, 126.9251121605252 37.51628731702501, 126.9201857196567 37.51809298103581, 126.9198497061859 37.51821646569524, 126.9197410000062 37.51825642040492, 126.9191518866807 37.51852618358289, 126.9183092943833 37.51891305215489, 126.91818070275 37.51899686639826, 126.9176262018576 37.51936030762003, 126.9174919212965 37.51944861332825, 126.9171994068788 37.51958466694873, 126.9166474453163 37.51989403495129, 126.9160151900539 37.52034271281393, 126.9158226245087 37.52063807885018, 126.9152277068853 37.52155119782608, 126.9136905874948 37.52374956855051, 126.9133830304248 37.52416835015541, 126.9132007364901 37.52441657606926, 126.9127069815974 37.52516092855557, 126.9119789822813 37.5262592934773, 126.9116287422085 37.52735384872476, 126.9097046752688 37.53337527100945, 126.909421112665 37.53426257889487, 126.9083636117838 37.53757223866262, 126.90800274386 37.53915655972921, 126.907822743401 37.53994683352055, 126.9077590055876 37.54094551386676, 126.9077129252561 37.54166765894863, 126.91451019651 37.54015593272531)))"
286,서울특별시,영등포구,당산1동,11560550,21509,10576,10933,"MULTIPOLYGON (((126.9028357295968 37.52612206788627, 126.9022304762056 37.52449882926128, 126.9022078308843 37.5244378374517, 126.9021349207563 37.52424146077694, 126.9010041788436 37.52040611775723, 126.9009742769206 37.52016598147087, 126.9009747800145 37.52013419338181, 126.9009756720509 37.52007923353742, 126.9009789163053 37.51993954062338, 126.9009830232993 37.51986745339097, 126.9010096552755 37.51945634714974, 126.901074719869 37.51910289689202, 126.9010872754464 37.51906393206647, 126.9010957575892 37.51903765833564, 126.9005944564992 37.51928298404578, 126.9004590645581 37.51932173094195, 126.9002861832717 37.51936028732842, 126.8996903174207 37.51949133612784, 126.8986171758815 37.51969544078325, 126.8922546215421 37.52073773343492, 126.8913806171848 37.52193315515871, 126.8915195180702 37.52259636222463, 126.8915542471532 37.52276103751324, 126.8916409547135 37.5231193922067, 126.8926349502169 37.52721701403377, 126.892822812547 37.52751318995656, 126.8929712257136 37.52770434490351, 126.8941452989702 37.52921334658073, 126.8965986428864 37.5280361540575, 126.8971957154065 37.52776429162134, 126.8972326318109 37.52774757974483, 126.9028357295968 37.52612206788627)))"
287,서울특별시,영등포구,당산2동,11560560,36238,17034,19204,"MULTIPOLYGON (((126.9077129252561 37.54166765894863, 126.9077590055876 37.54094551386676, 126.907822743401 37.53994683352055, 126.90800274386 37.53915655972921, 126.9083636117838 37.53757223866262, 126.909421112665 37.53426257889487, 126.9097046752688 37.53337527100945, 126.9116287422085 37.52735384872476, 126.9119789822813 37.5262592934773, 126.9127069815974 37.52516092855557, 126.9132007364901 37.52441657606926, 126.9124741740402 37.52409054352737, 126.9119373410555 37.52499034894823, 126.9114271577701 37.52584702876177, 126.9113954736306 37.52590023079339, 126.9103126958154 37.52632976688081, 126.9088946517583 37.52613001430313, 126.9084927372347 37.52601128615523, 126.908251925262 37.52592173846796, 126.9080249136956 37.52582708571519, 126.9079509443987 37.52578840754017, 126.907807164288 37.52572346727103, 126.9074567754221 37.52558210597151, 126.9070129292814 37.52567096688651, 126.9069014437975 37.52594538465261, 126.9068314146546 37.52611950728551, 126.9068033150984 37.52618938302403, 126.9066235849009 37.5267337969, 126.9065085444555 37.52723797570741, 126.9064740900327 37.52738990535043, 126.9064327307198 37.52761052820124, 126.9064009736994 37.52778049836592, 126.9063928420782 37.52809254986038, 126.9063886289189 37.52826716519907, 126.9065076392352 37.53207946295201, 126.9064008537268 37.53234917955945, 126.9054663408504 37.53214923998301, 126.9054386869129 37.53209537494219, 126.9052395139933 37.53170003175386, 126.9051744089641 37.53156362715904, 126.9050481630929 37.53129909418516, 126.9050175498321 37.53123471882076, 126.9048667447431 37.53091751324322, 126.9028357295968 37.52612206788627, 126.8972326318109 37.52774757974483, 126.8971957154065 37.52776429162134, 126.8965986428864 37.5280361540575, 126.8941452989702 37.52921334658073, 126.8947793868107 37.53004530266876, 126.898934305294 37.53535919585763, 126.9003109584894 37.53702799176335, 126.9005103012451 37.53731292858716, 126.9020362844181 37.53969909765821, 126.9040458723185 37.54284145707141, 126.9077129252561 37.54166765894863)))"
288,서울특별시,영등포구,양평1동,11560610,18251,9117,9134,"MULTIPOLYGON (((126.8900435815924 37.53037971846126, 126.8941452989702 37.52921334658073, 126.8929712257136 37.52770434490351, 126.892822812547 37.52751318995656, 126.8926349502169 37.52721701403377, 126.8916409547135 37.5231193922067, 126.8915542471532 37.52276103751324, 126.8915195180702 37.52259636222463, 126.8913806171848 37.52193315515871, 126.8922546215421 37.52073773343492, 126.8910549596219 37.52083858859032, 126.8899932115594 37.52102802648179, 126.8853591946765 37.52179268230676, 126.8851957671464 37.52136707056946, 126.8850097841216 37.52058756127728, 126.8837797834722 37.52076592685248, 126.8837420994964 37.52077145380079, 126.8834016402797 37.52082141432599, 126.8817997254471 37.52106992496812, 126.8798054802541 37.52138057002454, 126.8798227580196 37.52219530320006, 126.8802765808055 37.5243631348928, 126.8804883168931 37.52514734782051, 126.880509929507 37.52522627515442, 126.8813723376457 37.52599945718262, 126.8817318907785 37.52632158032202, 126.8847564854362 37.52740382490448, 126.8853460962087 37.52761420531862, 126.8860296686521 37.52792534638895, 126.8863143719969 37.52805526839077, 126.8865860313941 37.5283090574286, 126.8869559648205 37.52865687186527, 126.8870539851164 37.5287801894297, 126.887607780364 37.52947935348696, 126.8884819009021 37.53072097060306, 126.8900435815924 37.53037971846126)))"
289,서울특별시,영등포구,양평2동,11560620,22886,11432,11454,"MULTIPOLYGON (((126.8967563522268 37.54631737308835, 126.8984062718841 37.54540812513917, 126.8989237887093 37.54512292456586, 126.8992762718458 37.54492867538313, 126.9007181519882 37.54413492988729, 126.900866487906 37.54407709506619, 126.9040458723185 37.54284145707141, 126.9020362844181 37.53969909765821, 126.9005103012451 37.53731292858716, 126.9003109584894 37.53702799176335, 126.898934305294 37.53535919585763, 126.8947793868107 37.53004530266876, 126.8941452989702 37.52921334658073, 126.8900435815924 37.53037971846126, 126.8910707817996 37.53229256696007, 126.8915251232347 37.53313879629866, 126.8916339201603 37.53446321210658, 126.8912995163831 37.53583041215344, 126.8890185070711 37.54037381656402, 126.8879060786972 37.54240172409167, 126.8877375587081 37.54267688337181, 126.8872937300841 37.5433979119727, 126.8861657442654 37.54359603285742, 126.8857706731173 37.54423839161363, 126.885722621944 37.54431813614695, 126.8852754472667 37.54630327749581, 126.8866138037425 37.54745945376757, 126.8897544007029 37.55017183813918, 126.8967563522268 37.54631737308835)))"
290,서울특별시,영등포구,신길1동,11560630,19730,10121,9609,"MULTIPOLYGON (((126.9260111646754 37.51609788418517, 126.9251645713815 37.51490067462137, 126.9248397375659 37.51455426821544, 126.9247858054156 37.51448527744076, 126.9235204841229 37.51278427703762, 126.9224529781873 37.51013387955248, 126.9221043336401 37.50885112600672, 126.9220671164924 37.50808254014222, 126.9220628063112 37.50800027054974, 126.9205523409488 37.50717497694507, 126.9171385551992 37.50621665884488, 126.9161234537892 37.50564671321752, 126.9148124928101 37.50779444330917, 126.9137350982683 37.51138329319419, 126.9160451850334 37.51185541436587, 126.9161436046941 37.5118858258114, 126.9170547705604 37.51217483913597, 126.9170758279693 37.51219522349473, 126.9177502500732 37.51286329753034, 126.9177702608414 37.51288445627477, 126.9182881774634 37.51345078161201, 126.9183853662886 37.51358638197785, 126.9188407458316 37.51422511710609, 126.9184743564191 37.51443945356085, 126.9182561134112 37.51456709286025, 126.9176943614569 37.51505105493415, 126.9173011107052 37.51569132892543, 126.9172473926805 37.51577894572721, 126.9166904571347 37.51709442379615, 126.9167069399189 37.51733400339943, 126.9166558227161 37.5174559201689, 126.9174919212965 37.51944861332825, 126.9176262018576 37.51936030762003, 126.91818070275 37.51899686639826, 126.9183092943833 37.51891305215489, 126.9191518866807 37.51852618358289, 126.9197410000062 37.51825642040492, 126.9198497061859 37.51821646569524, 126.9201857196567 37.51809298103581, 126.9251121605252 37.51628731702501, 126.9252496564032 37.51623731486038, 126.9260111646754 37.51609788418517)))"
291,서울특별시,영등포구,신길3동,11560650,18703,9335,9368,"MULTIPOLYGON (((126.910160155436 37.50383464174522, 126.9088968139978 37.50422594072654, 126.908524977997 37.50449901477725, 126.9074991479189 37.50475644518026, 126.9030485261488 37.5042056522716, 126.9022705171413 37.50387272402826, 126.9009066275985 37.50328554594616, 126.900847109747 37.50325033916852, 126.9004795168208 37.50302568749981, 126.8982190224679 37.50533375222877, 126.9036931173784 37.50771179114437, 126.9043315455645 37.50799555844521, 126.9095226703862 37.51034486044725, 126.9096888683452 37.51042111184464, 126.9102949013125 37.51070588023117, 126.9106855382073 37.50968254030527, 126.91089138201 37.50886558944553, 126.9108960478504 37.50881783290131, 126.9109685995758 37.50803785652399, 126.9109765107431 37.50784072410076, 126.9110441495392 37.50607215668069, 126.9110387227698 37.50604283564032, 126.9110160271728 37.50592090457645, 126.9110013456633 37.50584633091211, 126.9109960342169 37.50581976047288, 126.9107658348155 37.50530865639325, 126.9107526215579 37.50527965703619, 126.9106337140404 37.50503017219238, 126.910160155436 37.50383464174522)))"
292,서울특별시,영등포구,신길4동,11560660,10082,5138,4944,"MULTIPOLYGON (((126.9161234537892 37.50564671321752, 126.9154544039581 37.50419334070578, 126.9130723670423 37.5042479975296, 126.9129389665865 37.50430704930148, 126.9127435763489 37.50428278709694, 126.9115259352027 37.50406228624787, 126.9113554476291 37.50395507705739, 126.9113353795485 37.50393267035134, 126.9112678337293 37.50381805469883, 126.9111679612624 37.50386488246544, 126.9111307560677 37.50387776842786, 126.9110083518727 37.50383082768133, 126.9109284798956 37.50386355324162, 126.9108689741972 37.50377689778735, 126.9108031174065 37.5038096841478, 126.9107652851597 37.50379654298528, 126.9107241356957 37.50378224955688, 126.9106603247275 37.50369639455453, 126.9105837402256 37.50374211487506, 126.9103821210971 37.50374036955639, 126.9103878543536 37.50369613900644, 126.9104021613848 37.5036330462593, 126.9102155968479 37.50361964558248, 126.910160155436 37.50383464174522, 126.9106337140404 37.50503017219238, 126.9107526215579 37.50527965703619, 126.9107658348155 37.50530865639325, 126.9109960342169 37.50581976047288, 126.9110013456633 37.50584633091211, 126.9110160271728 37.50592090457645, 126.9110387227698 37.50604283564032, 126.9110441495392 37.50607215668069, 126.9109765107431 37.50784072410076, 126.9109685995758 37.50803785652399, 126.9108960478504 37.50881783290131, 126.91089138201 37.50886558944553, 126.9106855382073 37.50968254030527, 126.9102949013125 37.51070588023117, 126.9137350982683 37.51138329319419, 126.9148124928101 37.50779444330917, 126.9161234537892 37.50564671321752)))"
293,서울특별시,영등포구,신길5동,11560670,10858,5408,5450,"MULTIPOLYGON (((126.910160155436 37.50383464174522, 126.9102155968479 37.50361964558248, 126.9102854502869 37.50318965293621, 126.9102882036254 37.50283815945679, 126.9102885081377 37.50275629101441, 126.9102888378319 37.50266690540605, 126.9102564106212 37.50202565560365, 126.9101936346413 37.50191433774388, 126.9099056144533 37.50140534871536, 126.9098198355982 37.50125394339302, 126.9093905632861 37.50072337912472, 126.9091895862426 37.50047562934836, 126.9090430571001 37.50031603274473, 126.9089072707209 37.50025573420705, 126.9087385715851 37.50018082027273, 126.9082647027973 37.49842632397421, 126.908168864419 37.49792757336265, 126.9081662925284 37.49744757120614, 126.9072850875152 37.49715231306775, 126.9037441653236 37.49729127531359, 126.9037072833518 37.49730573615772, 126.9036292503098 37.49733801633793, 126.9031276106288 37.49755856799342, 126.9025691206193 37.49799064913454, 126.9021368890526 37.49836035659004, 126.9020920488402 37.4983994782556, 126.902058669262 37.49842860331002, 126.9019702438581 37.4985196791846, 126.9019160842027 37.4985754782263, 126.9017043255306 37.49879523765296, 126.901169328773 37.49938291365617, 126.9010152127821 37.49968971930334, 126.9010249905311 37.49974598541952, 126.9010940297415 37.49982532200198, 126.9013112820299 37.50006866209731, 126.9013858736361 37.5001519241009, 126.9014202549038 37.50019089709636, 126.9014508182802 37.50025349685164, 126.9016174914673 37.50048200158637, 126.9016572105136 37.50053573868399, 126.9017258553186 37.50070509018898, 126.9017495075687 37.50074956559305, 126.9017739625023 37.50079553409345, 126.9018686955123 37.50097070336301, 126.9018930785305 37.50101577733057, 126.9020244071995 37.50121699339697, 126.9021756192455 37.50143222413778, 126.9013325032068 37.5022376509248, 126.9012064094414 37.5023541877583, 126.9004795168208 37.50302568749981, 126.900847109747 37.50325033916852, 126.9009066275985 37.50328554594616, 126.9022705171413 37.50387272402826, 126.9030485261488 37.5042056522716, 126.9074991479189 37.50475644518026, 126.908524977997 37.50449901477725, 126.9088968139978 37.50422594072654, 126.910160155436 37.50383464174522)))"
294,서울특별시,영등포구,신길6동,11560680,19593,9738,9855,"MULTIPOLYGON (((126.9154544039581 37.50419334070578, 126.9151024153159 37.50371155353373, 126.914947144344 37.50349903405191, 126.9146735783003 37.50312474364266, 126.9144650841439 37.50283978385922, 126.9135496728914 37.50176263148781, 126.9133021743752 37.50162845277685, 126.9129626883466 37.50150339333428, 126.9129108670926 37.50148454536713, 126.9126340820846 37.50125332413559, 126.9121782003177 37.50074217897365, 126.9121413273683 37.50069992027042, 126.9121099779032 37.50066167302993, 126.9120229880225 37.50055286124773, 126.9118525596057 37.5002849866454, 126.9118493367981 37.50024440965966, 126.9118428236073 37.50015759304341, 126.9150072963972 37.50027530100363, 126.9155547393481 37.50030621144413, 126.9166035583707 37.50109159647411, 126.9174167801789 37.50180993319305, 126.9174884774697 37.50184450217757, 126.9175996003597 37.5018975900365, 126.9202612223844 37.50156591462271, 126.9208267682982 37.50139855007433, 126.9202303933831 37.49851129881487, 126.9201882464516 37.49820125122424, 126.9198120249835 37.49782179042867, 126.9197280028735 37.49773704696692, 126.9197077455493 37.49771676161559, 126.9196844979976 37.49769401889954, 126.9195074045624 37.49764724279511, 126.9193585021796 37.49760791408131, 126.9184101359416 37.49735988301955, 126.9183671251375 37.4973495463394, 126.916523981113 37.49696074598693, 126.9160312655112 37.49685690891885, 126.9157968837893 37.49681068230968, 126.9152321063796 37.49669972535927, 126.9151053581724 37.49667568968693, 126.9150400328835 37.49666835369033, 126.9145469167403 37.49661633636192, 126.9142388918676 37.49658438869049, 126.9137771834071 37.49653498458179, 126.9127667251135 37.49641483588878, 126.9125251328833 37.4963854763693, 126.9120145496433 37.49603815889035, 126.9118169233803 37.49590309853992, 126.911710738296 37.49573919922571, 126.9112622999805 37.49504864010763, 126.9102872992103 37.49354918252937, 126.910009663425 37.49321368195537, 126.9094510848596 37.49258677822098, 126.9081662925284 37.49744757120614, 126.908168864419 37.49792757336265, 126.9082647027973 37.49842632397421, 126.9087385715851 37.50018082027273, 126.9089072707209 37.50025573420705, 126.9090430571001 37.50031603274473, 126.9091895862426 37.50047562934836, 126.9093905632861 37.50072337912472, 126.9098198355982 37.50125394339302, 126.9099056144533 37.50140534871536, 126.9101936346413 37.50191433774388, 126.9102564106212 37.50202565560365, 126.9102888378319 37.50266690540605, 126.9102885081377 37.50275629101441, 126.9102882036254 37.50283815945679, 126.9102854502869 37.50318965293621, 126.9102155968479 37.50361964558248, 126.9104021613848 37.5036330462593, 126.9103878543536 37.50369613900644, 126.9103821210971 37.50374036955639, 126.9105837402256 37.50374211487506, 126.9106603247275 37.50369639455453, 126.9107241356957 37.50378224955688, 126.9107652851597 37.50379654298528, 126.9108031174065 37.5038096841478, 126.9108689741972 37.50377689778735, 126.9109284798956 37.50386355324162, 126.9110083518727 37.50383082768133, 126.9111307560677 37.50387776842786, 126.9111679612624 37.50386488246544, 126.9112678337293 37.50381805469883, 126.9113353795485 37.50393267035134, 126.9113554476291 37.50395507705739, 126.9115259352027 37.50406228624787, 126.9127435763489 37.50428278709694, 126.9129389665865 37.50430704930148, 126.9130723670423 37.5042479975296, 126.9154544039581 37.50419334070578)))"
295,서울특별시,영등포구,신길7동,11560690,17092,8525,8567,"MULTIPOLYGON (((126.9208267682982 37.50139855007433, 126.9202612223844 37.50156591462271, 126.9175996003597 37.5018975900365, 126.9174884774697 37.50184450217757, 126.9174167801789 37.50180993319305, 126.9166035583707 37.50109159647411, 126.9155547393481 37.50030621144413, 126.9150072963972 37.50027530100363, 126.9118428236073 37.50015759304341, 126.9118493367981 37.50024440965966, 126.9118525596057 37.5002849866454, 126.9120229880225 37.50055286124773, 126.9121099779032 37.50066167302993, 126.9121413273683 37.50069992027042, 126.9121782003177 37.50074217897365, 126.9126340820846 37.50125332413559, 126.9129108670926 37.50148454536713, 126.9129626883466 37.50150339333428, 126.9133021743752 37.50162845277685, 126.9135496728914 37.50176263148781, 126.9144650841439 37.50283978385922, 126.9146735783003 37.50312474364266, 126.914947144344 37.50349903405191, 126.9151024153159 37.50371155353373, 126.9154544039581 37.50419334070578, 126.9161234537892 37.50564671321752, 126.9171385551992 37.50621665884488, 126.9205523409488 37.50717497694507, 126.9220628063112 37.50800027054974, 126.9220671164924 37.50808254014222, 126.9221043336401 37.50885112600672, 126.9224529781873 37.51013387955248, 126.9235204841229 37.51278427703762, 126.9247858054156 37.51448527744076, 126.9248397375659 37.51455426821544, 126.9251645713815 37.51490067462137, 126.9269776818079 37.5139699291985, 126.9270602318119 37.51392961465067, 126.9271041182286 37.51299917259274, 126.9268432800945 37.51289087149267, 126.9264447728306 37.51275260741826, 126.926411616043 37.51274117949563, 126.9258909927848 37.51266541517891, 126.9258451018052 37.51265902685862, 126.9257567673012 37.51264673562877, 126.9253952803573 37.51265217763108, 126.9252904997123 37.51239884917106, 126.9238253389143 37.50869841743291, 126.9220977401347 37.50438601204345, 126.9219797450393 37.50409812811345, 126.921532054772 37.50300867816129, 126.9213500502244 37.50256576892765, 126.9211523999763 37.50208518452841, 126.9211158883515 37.50200784066267, 126.9210862957351 37.50194521195336, 126.92091768721 37.50159002886474, 126.9208267682982 37.50139855007433)))"
296,서울특별시,영등포구,대림1동,11560700,16499,8524,7975,"MULTIPOLYGON (((126.9094510848596 37.49258677822098, 126.9063304591195 37.4889263202006, 126.9019250248963 37.49240011836713, 126.8999273019753 37.49483044452123, 126.9037441653236 37.49729127531359, 126.9072850875152 37.49715231306775, 126.9081662925284 37.49744757120614, 126.9094510848596 37.49258677822098)))"
297,서울특별시,영등포구,대림2동,11560710,21705,11361,10344,"MULTIPOLYGON (((126.9063304591195 37.4889263202006, 126.903226979492 37.48498628253719, 126.9029893856374 37.48498847306706, 126.9029073568314 37.48499143861561, 126.9027629200137 37.4850078036784, 126.9004505722706 37.48566520354548, 126.9002826926562 37.48576119676848, 126.8988359936735 37.48659097843399, 126.8985980563731 37.48672835090476, 126.8977026976685 37.48747642165152, 126.8975610640586 37.48759512821425, 126.8974176428072 37.48775889416138, 126.8953972611576 37.49203217901983, 126.8953703961293 37.49210401109809, 126.8999273019753 37.49483044452123, 126.9019250248963 37.49240011836713, 126.9063304591195 37.4889263202006)))"
298,서울특별시,영등포구,대림3동,11560720,28879,14804,14075,"MULTIPOLYGON (((126.8982190224679 37.50533375222877, 126.9004795168208 37.50302568749981, 126.9012064094414 37.5023541877583, 126.9013325032068 37.5022376509248, 126.9021756192455 37.50143222413778, 126.9020244071995 37.50121699339697, 126.9018930785305 37.50101577733057, 126.9018686955123 37.50097070336301, 126.9017739625023 37.50079553409345, 126.9017495075687 37.50074956559305, 126.9017258553186 37.50070509018898, 126.9016572105136 37.50053573868399, 126.9016174914673 37.50048200158637, 126.9014508182802 37.50025349685164, 126.9014202549038 37.50019089709636, 126.9013858736361 37.5001519241009, 126.9013112820299 37.50006866209731, 126.9010940297415 37.49982532200198, 126.9010249905311 37.49974598541952, 126.9010152127821 37.49968971930334, 126.901169328773 37.49938291365617, 126.9017043255306 37.49879523765296, 126.9019160842027 37.4985754782263, 126.9019702438581 37.4985196791846, 126.902058669262 37.49842860331002, 126.9020920488402 37.4983994782556, 126.9021368890526 37.49836035659004, 126.9025691206193 37.49799064913454, 126.9031276106288 37.49755856799342, 126.9036292503098 37.49733801633793, 126.9037072833518 37.49730573615772, 126.9037441653236 37.49729127531359, 126.8999273019753 37.49483044452123, 126.8953703961293 37.49210401109809, 126.8945462535908 37.49432239352335, 126.8935264738045 37.49772371857485, 126.8934508232876 37.49825402383242, 126.8934438820498 37.49841285088337, 126.8933264993038 37.5011242197743, 126.8933240841092 37.50118040043836, 126.8933099111808 37.50151281883764, 126.8933234708761 37.5020210263414, 126.8933320398392 37.50230989994807, 126.8933387162642 37.50251737163815, 126.8933444586877 37.50257321291207, 126.8934035562961 37.50313460866683, 126.893685131218 37.50441546253393, 126.8938556451389 37.50747806922447, 126.8951392320442 37.50815159034568, 126.897171365433 37.50626131124524, 126.8982190224679 37.50533375222877)))"
299,서울특별시,영등포구,영등포본동,11560515,24989,12884,12105,"MULTIPOLYGON (((126.9137350982683 37.51138329319419, 126.9102949013125 37.51070588023117, 126.9101930001612 37.51253559728698, 126.907624971854 37.51235551534067, 126.9073906239555 37.51221012254361, 126.905952259656 37.51114610677265, 126.9053234444824 37.51043308253189, 126.901913525062 37.51000434060886, 126.9018989164178 37.51003384271085, 126.9018752085677 37.5100810436574, 126.9006188047726 37.51226045449411, 126.8981571551902 37.51145362163084, 126.8978617393953 37.51187011705179, 126.8977944963756 37.51196554287021, 126.8978339163938 37.51198493272413, 126.8997572938382 37.51280815757401, 126.8999475870205 37.51288957011485, 126.9010019598338 37.51334064037106, 126.9024264407683 37.51394894030224, 126.9036372528749 37.51446601827222, 126.9040036031823 37.51463684835631, 126.9038634146501 37.51493135608982, 126.9059734844103 37.51567996979151, 126.9111989534422 37.51697253334184, 126.9159288265573 37.51726522468741, 126.9166558227161 37.5174559201689, 126.9167069399189 37.51733400339943, 126.9166904571347 37.51709442379615, 126.9172473926805 37.51577894572721, 126.9173011107052 37.51569132892543, 126.9176943614569 37.51505105493415, 126.9182561134112 37.51456709286025, 126.9184743564191 37.51443945356085, 126.9188407458316 37.51422511710609, 126.9183853662886 37.51358638197785, 126.9182881774634 37.51345078161201, 126.9177702608414 37.51288445627477, 126.9177502500732 37.51286329753034, 126.9170758279693 37.51219522349473, 126.9170547705604 37.51217483913597, 126.9161436046941 37.5118858258114, 126.9160451850334 37.51185541436587, 126.9137350982683 37.51138329319419)))"
300,서울특별시,영등포구,영등포동,11560535,27149,14750,12399,"MULTIPOLYGON (((126.9132007364901 37.52441657606926, 126.9133830304248 37.52416835015541, 126.9136905874948 37.52374956855051, 126.9152277068853 37.52155119782608, 126.9158226245087 37.52063807885018, 126.9160151900539 37.52034271281393, 126.9166474453163 37.51989403495129, 126.9171994068788 37.51958466694873, 126.9174919212965 37.51944861332825, 126.9166558227161 37.5174559201689, 126.9159288265573 37.51726522468741, 126.9111989534422 37.51697253334184, 126.9059734844103 37.51567996979151, 126.9038634146501 37.51493135608982, 126.9037877764696 37.5149447649845, 126.9034186388813 37.51501023202484, 126.9031944202317 37.51510261451881, 126.9031603961053 37.51512013612607, 126.9029818399028 37.51521549806603, 126.9028925632471 37.51526333126933, 126.9025642691016 37.51554785025209, 126.9025263865669 37.51559723295994, 126.9023569795072 37.51582284044117, 126.9021796248366 37.51611690203556, 126.9021097108107 37.51623301265872, 126.9020087657704 37.51647455862715, 126.901919354345 37.51668930353353, 126.901425688203 37.51801967576696, 126.9012813892056 37.51846398555016, 126.9011508646828 37.51886667838041, 126.9010957575892 37.51903765833564, 126.9010872754464 37.51906393206647, 126.901074719869 37.51910289689202, 126.9010096552755 37.51945634714974, 126.9009830232993 37.51986745339097, 126.9009789163053 37.51993954062338, 126.9009756720509 37.52007923353742, 126.9009747800145 37.52013419338181, 126.9009742769206 37.52016598147087, 126.9010041788436 37.52040611775723, 126.9021349207563 37.52424146077694, 126.9022078308843 37.5244378374517, 126.9022304762056 37.52449882926128, 126.9028357295968 37.52612206788627, 126.9048667447431 37.53091751324322, 126.9050175498321 37.53123471882076, 126.9050481630929 37.53129909418516, 126.9051744089641 37.53156362715904, 126.9052395139933 37.53170003175386, 126.9054386869129 37.53209537494219, 126.9054663408504 37.53214923998301, 126.9064008537268 37.53234917955945, 126.9065076392352 37.53207946295201, 126.9063886289189 37.52826716519907, 126.9063928420782 37.52809254986038, 126.9064009736994 37.52778049836592, 126.9064327307198 37.52761052820124, 126.9064740900327 37.52738990535043, 126.9065085444555 37.52723797570741, 126.9066235849009 37.5267337969, 126.9068033150984 37.52618938302403, 126.9068314146546 37.52611950728551, 126.9069014437975 37.52594538465261, 126.9070129292814 37.52567096688651, 126.9074567754221 37.52558210597151, 126.907807164288 37.52572346727103, 126.9079509443987 37.52578840754017, 126.9080249136956 37.52582708571519, 126.908251925262 37.52592173846796, 126.9084927372347 37.52601128615523, 126.9088946517583 37.52613001430313, 126.9103126958154 37.52632976688081, 126.9113954736306 37.52590023079339, 126.9114271577701 37.52584702876177, 126.9119373410555 37.52499034894823, 126.9124741740402 37.52409054352737, 126.9132007364901 37.52441657606926)))"
301,서울특별시,영등포구,도림동,11560585,21778,11116,10662,"MULTIPOLYGON (((126.9102949013125 37.51070588023117, 126.9096888683452 37.51042111184464, 126.9095226703862 37.51034486044725, 126.9043315455645 37.50799555844521, 126.9036931173784 37.50771179114437, 126.8982190224679 37.50533375222877, 126.897171365433 37.50626131124524, 126.8951392320442 37.50815159034568, 126.8929696244947 37.50946107193752, 126.8981571551902 37.51145362163084, 126.9006188047726 37.51226045449411, 126.9018752085677 37.5100810436574, 126.9018989164178 37.51003384271085, 126.901913525062 37.51000434060886, 126.9053234444824 37.51043308253189, 126.905952259656 37.51114610677265, 126.9073906239555 37.51221012254361, 126.907624971854 37.51235551534067, 126.9101930001612 37.51253559728698, 126.9102949013125 37.51070588023117)))"
302,서울특별시,영등포구,문래동,11560605,31961,15769,16192,"MULTIPOLYGON (((126.8922546215421 37.52073773343492, 126.8986171758815 37.51969544078325, 126.8996903174207 37.51949133612784, 126.9002861832717 37.51936028732842, 126.9004590645581 37.51932173094195, 126.9005944564992 37.51928298404578, 126.9010957575892 37.51903765833564, 126.9011508646828 37.51886667838041, 126.9012813892056 37.51846398555016, 126.901425688203 37.51801967576696, 126.901919354345 37.51668930353353, 126.9020087657704 37.51647455862715, 126.9021097108107 37.51623301265872, 126.9021796248366 37.51611690203556, 126.9023569795072 37.51582284044117, 126.9025263865669 37.51559723295994, 126.9025642691016 37.51554785025209, 126.9028925632471 37.51526333126933, 126.9029818399028 37.51521549806603, 126.9031603961053 37.51512013612607, 126.9031944202317 37.51510261451881, 126.9034186388813 37.51501023202484, 126.9037877764696 37.5149447649845, 126.9038634146501 37.51493135608982, 126.9040036031823 37.51463684835631, 126.9036372528749 37.51446601827222, 126.9024264407683 37.51394894030224, 126.9010019598338 37.51334064037106, 126.8999475870205 37.51288957011485, 126.8997572938382 37.51280815757401, 126.8978339163938 37.51198493272413, 126.8977944963756 37.51196554287021, 126.8978617393953 37.51187011705179, 126.8981571551902 37.51145362163084, 126.8929696244947 37.50946107193752, 126.8917480693434 37.50986935563009, 126.8912163968866 37.51065601507445, 126.8911868753152 37.51069569094397, 126.8908994500011 37.51108179034174, 126.8907923611343 37.5112018380099, 126.8906753601249 37.51133188631739, 126.89044510236 37.51155828954258, 126.8902886285903 37.51166789749873, 126.8896275505574 37.51208585237993, 126.8885217011426 37.51266489693496, 126.8817334166011 37.51581502279236, 126.8794730017385 37.51677180493008, 126.8798054802541 37.52138057002454, 126.8817997254471 37.52106992496812, 126.8834016402797 37.52082141432599, 126.8837420994964 37.52077145380079, 126.8837797834722 37.52076592685248, 126.8850097841216 37.52058756127728, 126.8851957671464 37.52136707056946, 126.8853591946765 37.52179268230676, 126.8899932115594 37.52102802648179, 126.8910549596219 37.52083858859032, 126.8922546215421 37.52073773343492)))"
303,서울특별시,동작구,노량진2동,11590520,13954,7169,6785,"MULTIPOLYGON (((126.940592740653 37.50597691740642, 126.9405528598762 37.50592040739317, 126.9392429096554 37.50539704473857, 126.9386516021821 37.50540777904042, 126.9383471599567 37.5054660240713, 126.9382244640352 37.50551501510964, 126.9382134591918 37.50575607509773, 126.9378324631144 37.50611367575818, 126.9362859825669 37.50704822083782, 126.9361336766678 37.50708467474549, 126.9359021442666 37.50712300351508, 126.9352564254815 37.50704104957637, 126.9348519155318 37.50901420773742, 126.9348501356443 37.51056340003435, 126.9343756979782 37.51308266519524, 126.9330401376128 37.51453085647642, 126.9330396919411 37.51475579597079, 126.9330396402008 37.51478432354161, 126.933038657393 37.51576455353615, 126.9384822055998 37.51678990985248, 126.939133257101 37.51419260967873, 126.9402406921176 37.51324230335057, 126.9417141715629 37.50938867440667, 126.9428055589392 37.50985532557275, 126.9437968500491 37.50949720256274, 126.9440377149323 37.50885948460824, 126.9426673388237 37.50712647339908, 126.9424315623571 37.50690281898783, 126.94230334334 37.50680804648115, 126.9416627461458 37.50681912644043, 126.9409013532795 37.50679073778741, 126.9403030231432 37.50614790651626, 126.940592740653 37.50597691740642)))"
304,서울특별시,동작구,상도1동,11590530,48372,23364,25008,"MULTIPOLYGON (((126.953977047939 37.50769016454512, 126.9544291836096 37.50677963098455, 126.9538738471048 37.50409328070336, 126.9566762948345 37.49930080304237, 126.9567532801791 37.49920994346028, 126.957550482584 37.49877306900397, 126.9576478385983 37.49874546580951, 126.9592041008044 37.49831416727712, 126.9611693461596 37.49778011101165, 126.9629770643624 37.4945558514855, 126.9622304850224 37.49415473146144, 126.9612379763086 37.49255940112582, 126.9612143391497 37.49328823271334, 126.9611988013529 37.49338826658658, 126.9603484423575 37.49385095469889, 126.9602272771721 37.49388758212987, 126.9591251801317 37.4938656409729, 126.9589489656749 37.49379047209877, 126.9586758902565 37.49293067843028, 126.9573707628801 37.49181117397192, 126.9573182182086 37.49178535930284, 126.956713987297 37.49155498942338, 126.9562845517183 37.49157443995303, 126.9561064768599 37.49158255811371, 126.9548042761398 37.49117776285546, 126.9540410230345 37.49103903447582, 126.9534563528154 37.49113378763044, 126.9533960659656 37.49115886118762, 126.9512468198595 37.49241079747357, 126.948517627446 37.49367688961615, 126.9476797745938 37.49373974698315, 126.9473924874278 37.49390934396739, 126.9478509170148 37.49607589048604, 126.948269428145 37.49685301224471, 126.9482751812056 37.49691215005468, 126.9482806078567 37.49696798737563, 126.948282886952 37.49858029871393, 126.9482805693184 37.49870309763807, 126.9482555102718 37.49874466740989, 126.9479368157382 37.49919836319754, 126.9478784132275 37.49925555168281, 126.9479268942317 37.50016163991943, 126.9479082075981 37.50039477837092, 126.9473506277047 37.50121578479116, 126.9472618800014 37.50133777003344, 126.9464526644073 37.50226278789374, 126.9479521888785 37.50412096356493, 126.9481722040902 37.5042094599882, 126.9492723071575 37.50489437175723, 126.9498061327122 37.50559217727664, 126.9503471128169 37.50644973911595, 126.9501910590156 37.50680392131323, 126.9503146278495 37.50779485089666, 126.9537370173505 37.50792678706305, 126.953977047939 37.50769016454512)))"
305,서울특별시,동작구,상도2동,11590540,29396,14108,15288,"MULTIPOLYGON (((126.9478784132275 37.49925555168281, 126.939781886581 37.50046016614132, 126.9363575345109 37.50326845913354, 126.933172736003 37.50363746991778, 126.932664279989 37.50408908812611, 126.9326535852912 37.50412058326646, 126.9325843191091 37.50439741706334, 126.9325779795576 37.50443079441199, 126.9325658735017 37.50459224635374, 126.9327006719619 37.50556072304544, 126.9327115264848 37.50562161748994, 126.9331193553141 37.50564723504564, 126.9331793063785 37.50557428770438, 126.9332235561013 37.50552041877341, 126.933347746617 37.50536842432505, 126.9334710632565 37.50523767948513, 126.9337273936757 37.50519158748493, 126.9339401289678 37.50520728207849, 126.9340091535265 37.50524363906505, 126.934468143016 37.50560975926179, 126.9344877115415 37.5057349158614, 126.9345215030564 37.50594319583677, 126.9345389887321 37.50596726007426, 126.9345764515514 37.50601733387232, 126.934581698031 37.50606052934918, 126.9345957374364 37.50620625540075, 126.9346288999186 37.50623471665548, 126.9347189617935 37.5062948633073, 126.9347492583318 37.50640316989716, 126.9348124056418 37.50656346243478, 126.9348971552262 37.50676554681667, 126.9352564254815 37.50704104957637, 126.9359021442666 37.50712300351508, 126.9361336766678 37.50708467474549, 126.9362859825669 37.50704822083782, 126.9378324631144 37.50611367575818, 126.9382134591918 37.50575607509773, 126.9382244640352 37.50551501510964, 126.9383471599567 37.5054660240713, 126.9386516021821 37.50540777904042, 126.9392429096554 37.50539704473857, 126.9405528598762 37.50592040739317, 126.940592740653 37.50597691740642, 126.9424859930318 37.50632614501968, 126.9473246392993 37.50665984897768, 126.9485590160322 37.50689320916935, 126.9497798276723 37.5071467701659, 126.9503146278495 37.50779485089666, 126.9501910590156 37.50680392131323, 126.9503471128169 37.50644973911595, 126.9498061327122 37.50559217727664, 126.9492723071575 37.50489437175723, 126.9481722040902 37.5042094599882, 126.9479521888785 37.50412096356493, 126.9464526644073 37.50226278789374, 126.9472618800014 37.50133777003344, 126.9473506277047 37.50121578479116, 126.9479082075981 37.50039477837092, 126.9479268942317 37.50016163991943, 126.9478784132275 37.49925555168281)))"
306,서울특별시,동작구,상도3동,11590550,26111,12534,13577,"MULTIPOLYGON (((126.9363575345109 37.50326845913354, 126.9319448743365 37.50051724212114, 126.9320133930534 37.50041969886021, 126.9356581677162 37.49650838341519, 126.9365792820562 37.49577930182345, 126.938890775004 37.49396167815195, 126.9397188896187 37.49336288506927, 126.9416462019981 37.49225195182756, 126.9395092087006 37.49087629868787, 126.9391468225295 37.49158331202649, 126.9361217357496 37.49240492002553, 126.9334516467208 37.49302084129663, 126.9311154700311 37.49341860489839, 126.92986951577 37.49400073499751, 126.9293850597013 37.49534750567167, 126.9293927740798 37.49563636072492, 126.9294196586831 37.49582489824329, 126.9297039624214 37.49697965915102, 126.9299535749313 37.49746253113457, 126.9301656039878 37.49783630420063, 126.9300703222733 37.49781443735858, 126.9300173744556 37.49780291495577, 126.9299141641597 37.49780016353332, 126.9298646715605 37.49779992467824, 126.9297805107046 37.4978028985464, 126.9297309786596 37.49780829291573, 126.9297133481813 37.49783168540694, 126.9296629824879 37.49786398388358, 126.9296164887332 37.49789336892486, 126.9295459379435 37.49794578458306, 126.9285845070445 37.4988662303122, 126.9290498697724 37.49898509325515, 126.9301255945378 37.49947319761488, 126.9302960315882 37.49955398793021, 126.9303816125143 37.49973233353226, 126.9303621134838 37.49979882621012, 126.9303063891048 37.49996643486114, 126.9301115026045 37.50039701853238, 126.9299208194469 37.5005527088833, 126.9298681712482 37.50059526915345, 126.9293543784876 37.50074601860632, 126.9288936730551 37.50079787345172, 126.928766502438 37.50115449701836, 126.9283263793074 37.50295725301096, 126.9283150368672 37.50314648346011, 126.9283253130768 37.50320243970329, 126.9283388714104 37.50326715496693, 126.9283689011907 37.50331574809206, 126.9284412989769 37.50337355976243, 126.9285145593222 37.50341188377172, 126.9286323135585 37.50345335236152, 126.9286704534723 37.50345917480901, 126.9291318117265 37.50351097532369, 126.9294555221869 37.5035305663794, 126.9303059489946 37.50357862723833, 126.9310994897729 37.50363426422866, 126.932055808943 37.5037819561105, 126.9321720812489 37.50383434297579, 126.932664279989 37.50408908812611, 126.933172736003 37.50363746991778, 126.9363575345109 37.50326845913354)))"
307,서울특별시,동작구,상도4동,11590560,30107,14709,15398,"MULTIPOLYGON (((126.9478784132275 37.49925555168281, 126.9479368157382 37.49919836319754, 126.9482555102718 37.49874466740989, 126.9482805693184 37.49870309763807, 126.948282886952 37.49858029871393, 126.9482806078567 37.49696798737563, 126.9482751812056 37.49691215005468, 126.948269428145 37.49685301224471, 126.9478509170148 37.49607589048604, 126.9473924874278 37.49390934396739, 126.9433879771593 37.49208221718774, 126.9428290000847 37.49223731964081, 126.9416462019981 37.49225195182756, 126.9397188896187 37.49336288506927, 126.938890775004 37.49396167815195, 126.9365792820562 37.49577930182345, 126.9356581677162 37.49650838341519, 126.9320133930534 37.50041969886021, 126.9319448743365 37.50051724212114, 126.9363575345109 37.50326845913354, 126.939781886581 37.50046016614132, 126.9478784132275 37.49925555168281)))"
308,서울특별시,동작구,사당1동,11590620,24139,11541,12598,"MULTIPOLYGON (((126.9820701724793 37.48480590653122, 126.9818078281263 37.48058889244171, 126.9816097529059 37.47715329934684, 126.9817228223633 37.47636480563454, 126.9793880695864 37.47662015792076, 126.9772741156172 37.47657927604376, 126.9769186186389 37.47657207016604, 126.9751518691319 37.47630589653419, 126.9749414854638 37.47627373869589, 126.9748306321371 37.47625521882692, 126.973448332394 37.476007951995, 126.9727000668451 37.47587392409821, 126.972367501544 37.47581384564384, 126.9719638498903 37.47571852628742, 126.971517860694 37.47561287589228, 126.970945905803 37.47547672478279, 126.9704905925551 37.4753683309936, 126.9701867668624 37.47662545179693, 126.9709493950804 37.47733869099412, 126.9743288830963 37.48043467986347, 126.9747113354775 37.48041596142984, 126.9755892513979 37.48149999667637, 126.9756699295519 37.48218791992388, 126.9756855884765 37.48328624269165, 126.9791764301597 37.48439117925221, 126.9817921398784 37.48485432071491, 126.9820701724793 37.48480590653122)))"
309,서울특별시,동작구,사당3동,11590640,26276,12777,13499,"MULTIPOLYGON (((126.9791764301597 37.48439117925221, 126.9756855884765 37.48328624269165, 126.974560126619 37.48329095852395, 126.9708424539811 37.48478342259058, 126.9700358729157 37.48508065383961, 126.9700010414788 37.48510531200086, 126.9699726328185 37.48512543809006, 126.969439692199 37.48551175697955, 126.9671402421114 37.48736721962457, 126.966782549191 37.4876619273457, 126.9663665197144 37.48800594518144, 126.9633674027333 37.49227606360113, 126.9622304850224 37.49415473146144, 126.9629770643624 37.4945558514855, 126.9650379834286 37.49320602645641, 126.9658474757083 37.49348498191867, 126.9659054545691 37.49350283855194, 126.9660168029471 37.49353532206641, 126.9669252345375 37.4937467369453, 126.9676259503838 37.4938866777504, 126.9680584943891 37.49396141080884, 126.9724059647908 37.49326432722798, 126.9726279296566 37.4927616125547, 126.9727021194824 37.49166686601253, 126.9736227281905 37.49035052241633, 126.9757180920524 37.48804221289591, 126.9764935966491 37.48723890421982, 126.9766194194934 37.48713918552295, 126.9767141252598 37.48708879093308, 126.9780154345407 37.48676791764983, 126.9785782578113 37.48676253411581, 126.9791764301597 37.48439117925221)))"
310,서울특별시,동작구,사당4동,11590650,14902,7139,7763,"MULTIPOLYGON (((126.9756855884765 37.48328624269165, 126.9756699295519 37.48218791992388, 126.9755892513979 37.48149999667637, 126.9747113354775 37.48041596142984, 126.9743288830963 37.48043467986347, 126.9709493950804 37.47733869099412, 126.9701867668624 37.47662545179693, 126.9697661608377 37.47663393697918, 126.969592915783 37.47663743454625, 126.9688018212856 37.47665416121276, 126.9682126344067 37.47730387019961, 126.9678175488172 37.47779445919247, 126.96682013817 37.47858210900811, 126.9658924577129 37.47922344130743, 126.96532097621 37.47956449986047, 126.9653843231847 37.47966001604437, 126.9654982789059 37.47983182056852, 126.9670473110348 37.48136846552899, 126.9684309453638 37.48200995065746, 126.9685332829046 37.48203407172457, 126.9690064468609 37.48210042104635, 126.9696599618942 37.48212478072212, 126.971075111948 37.4844746402842, 126.9708424539811 37.48478342259058, 126.974560126619 37.48329095852395, 126.9756855884765 37.48328624269165)))"
311,서울특별시,동작구,사당5동,11590651,12957,6271,6686,"MULTIPOLYGON (((126.9708424539811 37.48478342259058, 126.971075111948 37.4844746402842, 126.9696599618942 37.48212478072212, 126.9690064468609 37.48210042104635, 126.9685332829046 37.48203407172457, 126.9684309453638 37.48200995065746, 126.9670473110348 37.48136846552899, 126.9654982789059 37.47983182056852, 126.9653843231847 37.47966001604437, 126.96532097621 37.47956449986047, 126.9644419136359 37.48021513079799, 126.9613448433316 37.48348537950942, 126.9613771733559 37.4837086131929, 126.9613862712286 37.48375959045055, 126.9613942291648 37.48378974292677, 126.9614060616772 37.4838202871292, 126.962148068574 37.48523880042369, 126.9621392330692 37.48647136875792, 126.9620668999128 37.48729127546255, 126.9610672793939 37.49112969511851, 126.9612465395746 37.49242838551737, 126.9612379763086 37.49255940112582, 126.9622304850224 37.49415473146144, 126.9633674027333 37.49227606360113, 126.9663665197144 37.48800594518144, 126.966782549191 37.4876619273457, 126.9671402421114 37.48736721962457, 126.969439692199 37.48551175697955, 126.9699726328185 37.48512543809006, 126.9700010414788 37.48510531200086, 126.9700358729157 37.48508065383961, 126.9708424539811 37.48478342259058)))"
312,서울특별시,동작구,대방동,11590660,40244,19148,21096,"MULTIPOLYGON (((126.933038657393 37.51576455353615, 126.9330396402008 37.51478432354161, 126.9330396919411 37.51475579597079, 126.9330401376128 37.51453085647642, 126.9343756979782 37.51308266519524, 126.9348501356443 37.51056340003435, 126.9348519155318 37.50901420773742, 126.9352564254815 37.50704104957637, 126.9348971552262 37.50676554681667, 126.9348124056418 37.50656346243478, 126.9347492583318 37.50640316989716, 126.9347189617935 37.5062948633073, 126.9346288999186 37.50623471665548, 126.9345957374364 37.50620625540075, 126.934581698031 37.50606052934918, 126.9345764515514 37.50601733387232, 126.9345389887321 37.50596726007426, 126.9345215030564 37.50594319583677, 126.9344877115415 37.5057349158614, 126.934468143016 37.50560975926179, 126.9340091535265 37.50524363906505, 126.9339401289678 37.50520728207849, 126.9337273936757 37.50519158748493, 126.9334710632565 37.50523767948513, 126.933347746617 37.50536842432505, 126.9332235561013 37.50552041877341, 126.9331793063785 37.50557428770438, 126.9331193553141 37.50564723504564, 126.9327115264848 37.50562161748994, 126.9327006719619 37.50556072304544, 126.9325658735017 37.50459224635374, 126.9325779795576 37.50443079441199, 126.9325843191091 37.50439741706334, 126.9326535852912 37.50412058326646, 126.932664279989 37.50408908812611, 126.9321720812489 37.50383434297579, 126.932055808943 37.5037819561105, 126.9310994897729 37.50363426422866, 126.9303059489946 37.50357862723833, 126.9294555221869 37.5035305663794, 126.9291318117265 37.50351097532369, 126.9286704534723 37.50345917480901, 126.9286323135585 37.50345335236152, 126.9285145593222 37.50341188377172, 126.9284412989769 37.50337355976243, 126.9283689011907 37.50331574809206, 126.9283388714104 37.50326715496693, 126.9283253130768 37.50320243970329, 126.9283150368672 37.50314648346011, 126.9283263793074 37.50295725301096, 126.928766502438 37.50115449701836, 126.9288936730551 37.50079787345172, 126.9293543784876 37.50074601860632, 126.9298681712482 37.50059526915345, 126.9299208194469 37.5005527088833, 126.9301115026045 37.50039701853238, 126.9303063891048 37.49996643486114, 126.9303621134838 37.49979882621012, 126.9303816125143 37.49973233353226, 126.9302960315882 37.49955398793021, 126.9301255945378 37.49947319761488, 126.9290498697724 37.49898509325515, 126.9285845070445 37.4988662303122, 126.9282316030145 37.49897393371675, 126.9281756363373 37.49898718314195, 126.9273589151408 37.49917927158815, 126.9271322460546 37.49923225387923, 126.9266197701225 37.49923202001074, 126.9265602229184 37.49923173096428, 126.9260634426538 37.49910087530296, 126.9259869623443 37.49908058375161, 126.9259293707453 37.49906529632967, 126.9254829109441 37.49892003574135, 126.9240306928216 37.49844607119366, 126.9239951482987 37.49843412618745, 126.9231273545693 37.49813113752322, 126.9229956112982 37.49808297466689, 126.9229024276205 37.49804891696428, 126.9224769438547 37.49793877415716, 126.9222003021331 37.49786738699491, 126.9220052167337 37.49786200428013, 126.9211467488596 37.49813051748499, 126.9208922053086 37.49823963181577, 126.9202303933831 37.49851129881487, 126.9208267682982 37.50139855007433, 126.92091768721 37.50159002886474, 126.9210862957351 37.50194521195336, 126.9211158883515 37.50200784066267, 126.9211523999763 37.50208518452841, 126.9213500502244 37.50256576892765, 126.921532054772 37.50300867816129, 126.9219797450393 37.50409812811345, 126.9220977401347 37.50438601204345, 126.9238253389143 37.50869841743291, 126.9252904997123 37.51239884917106, 126.9253952803573 37.51265217763108, 126.9257567673012 37.51264673562877, 126.9258451018052 37.51265902685862, 126.9258909927848 37.51266541517891, 126.926411616043 37.51274117949563, 126.9264447728306 37.51275260741826, 126.9268432800945 37.51289087149267, 126.9271041182286 37.51299917259274, 126.9270602318119 37.51392961465067, 126.9269776818079 37.5139699291985, 126.9251645713815 37.51490067462137, 126.9260111646754 37.51609788418517, 126.9321534490204 37.51565431547159, 126.933038657393 37.51576455353615)))"
313,서울특별시,동작구,신대방1동,11590670,26747,13063,13684,"MULTIPOLYGON (((126.9159684432826 37.48876242670654, 126.9138151814709 37.48752633178206, 126.9133235005701 37.48724737673505, 126.9132388855121 37.48720530124272, 126.9111549597577 37.4864693682276, 126.9104158878683 37.4862380898109, 126.9103792162795 37.48622663984582, 126.9092261732701 37.48586709738408, 126.9090817641353 37.48582246110652, 126.908992746886 37.48579494810849, 126.9087178142574 37.48571135975195, 126.9077667789163 37.48542446270434, 126.9074629083846 37.48534674742868, 126.9067036735653 37.48516491929299, 126.9059634901976 37.48498881555482, 126.9056115187601 37.48497803174432, 126.9051330132761 37.48496548315135, 126.903226979492 37.48498628253719, 126.9063304591195 37.4889263202006, 126.9094510848596 37.49258677822098, 126.910009663425 37.49321368195537, 126.9102872992103 37.49354918252937, 126.9112622999805 37.49504864010763, 126.911710738296 37.49573919922571, 126.9118169233803 37.49590309853992, 126.9120145496433 37.49603815889035, 126.9125251328833 37.4963854763693, 126.9127667251135 37.49641483588878, 126.9137771834071 37.49653498458179, 126.9142388918676 37.49658438869049, 126.9145980596116 37.49305285777506, 126.9155500101696 37.49050515727448, 126.9159684432826 37.48876242670654)))"
314,서울특별시,동작구,신대방2동,11590680,20726,9963,10763,"MULTIPOLYGON (((126.9285845070445 37.4988662303122, 126.9295459379435 37.49794578458306, 126.9296164887332 37.49789336892486, 126.9296629824879 37.49786398388358, 126.9297133481813 37.49783168540694, 126.9297309786596 37.49780829291573, 126.9297805107046 37.4978028985464, 126.9298646715605 37.49779992467824, 126.9299141641597 37.49780016353332, 126.9300173744556 37.49780291495577, 126.9300703222733 37.49781443735858, 126.9301656039878 37.49783630420063, 126.9299535749313 37.49746253113457, 126.9297039624214 37.49697965915102, 126.9294196586831 37.49582489824329, 126.9293927740798 37.49563636072492, 126.9293850597013 37.49534750567167, 126.92986951577 37.49400073499751, 126.9291807307874 37.49439062355042, 126.9290408217733 37.49447332285067, 126.9289200903379 37.49454372104947, 126.9285153797444 37.49476710286939, 126.9284756241472 37.49478831774087, 126.9280997669711 37.49493634916632, 126.928036760102 37.4949461843786, 126.927805307024 37.49497999107371, 126.927721811034 37.49498860018031, 126.9274032361827 37.49494874886246, 126.927365907951 37.4949305408134, 126.9268285748417 37.49437360212252, 126.9266006791538 37.4941257500562, 126.9265707567631 37.4940582582179, 126.9265504240686 37.49400540136513, 126.926523362188 37.49393116863888, 126.9258274318041 37.4926061653232, 126.9248812018461 37.49089729754878, 126.9243009287529 37.48996491069668, 126.9188907014525 37.48956214246951, 126.9159684432826 37.48876242670654, 126.9155500101696 37.49050515727448, 126.9145980596116 37.49305285777506, 126.9142388918676 37.49658438869049, 126.9145469167403 37.49661633636192, 126.9150400328835 37.49666835369033, 126.9151053581724 37.49667568968693, 126.9152321063796 37.49669972535927, 126.9157968837893 37.49681068230968, 126.9160312655112 37.49685690891885, 126.916523981113 37.49696074598693, 126.9183671251375 37.4973495463394, 126.9184101359416 37.49735988301955, 126.9193585021796 37.49760791408131, 126.9195074045624 37.49764724279511, 126.9196844979976 37.49769401889954, 126.9197077455493 37.49771676161559, 126.9197280028735 37.49773704696692, 126.9198120249835 37.49782179042867, 126.9201882464516 37.49820125122424, 126.9202303933831 37.49851129881487, 126.9208922053086 37.49823963181577, 126.9211467488596 37.49813051748499, 126.9220052167337 37.49786200428013, 126.9222003021331 37.49786738699491, 126.9224769438547 37.49793877415716, 126.9229024276205 37.49804891696428, 126.9229956112982 37.49808297466689, 126.9231273545693 37.49813113752322, 126.9239951482987 37.49843412618745, 126.9240306928216 37.49844607119366, 126.9254829109441 37.49892003574135, 126.9259293707453 37.49906529632967, 126.9259869623443 37.49908058375161, 126.9260634426538 37.49910087530296, 126.9265602229184 37.49923173096428, 126.9266197701225 37.49923202001074, 126.9271322460546 37.49923225387923, 126.9273589151408 37.49917927158815, 126.9281756363373 37.49898718314195, 126.9282316030145 37.49897393371675, 126.9285845070445 37.4988662303122)))"
315,서울특별시,동작구,흑석동,11590605,35482,16891,18591,"MULTIPOLYGON (((126.9755930365814 37.51229601135129, 126.9735936102657 37.5083920283201, 126.9735244226156 37.50696768634415, 126.9737614315115 37.50684435538361, 126.9742135755984 37.5066090869442, 126.9733632171289 37.50535354088191, 126.9717051831345 37.50425195324293, 126.9716796190407 37.50423510974119, 126.9716507367657 37.50422032451118, 126.9715299960708 37.50416061037776, 126.9714231346626 37.50410776346568, 126.9696208242318 37.50368618781078, 126.9687777634607 37.50351114184685, 126.9665228716767 37.50190670724877, 126.965431938458 37.50079876780312, 126.9621276422851 37.49754217998631, 126.9620888519366 37.49750958606946, 126.9619954821777 37.49743126112588, 126.9618070139158 37.49751084421678, 126.9611693461596 37.49778011101165, 126.9592041008044 37.49831416727712, 126.9576478385983 37.49874546580951, 126.957550482584 37.49877306900397, 126.9567532801791 37.49920994346028, 126.9566762948345 37.49930080304237, 126.9538738471048 37.50409328070336, 126.9544291836096 37.50677963098455, 126.953977047939 37.50769016454512, 126.9542891618503 37.50765555271165, 126.9570865438164 37.50987410618816, 126.9598239824839 37.51167737869691, 126.962401915494 37.5133577120267, 126.9629562589911 37.51315748588056, 126.9634258740935 37.51304921329295, 126.9646025199765 37.51277850390171, 126.9676723087916 37.51260534777674, 126.9755930365814 37.51229601135129)))"
316,서울특별시,동작구,노량진1동,11590510,32603,16165,16438,"MULTIPOLYGON (((126.9571981610347 37.51541394716001, 126.962401915494 37.5133577120267, 126.9598239824839 37.51167737869691, 126.9570865438164 37.50987410618816, 126.9542891618503 37.50765555271165, 126.953977047939 37.50769016454512, 126.9537370173505 37.50792678706305, 126.9503146278495 37.50779485089666, 126.9497798276723 37.5071467701659, 126.9485590160322 37.50689320916935, 126.9473246392993 37.50665984897768, 126.9424859930318 37.50632614501968, 126.940592740653 37.50597691740642, 126.9403030231432 37.50614790651626, 126.9409013532795 37.50679073778741, 126.9416627461458 37.50681912644043, 126.94230334334 37.50680804648115, 126.9424315623571 37.50690281898783, 126.9426673388237 37.50712647339908, 126.9440377149323 37.50885948460824, 126.9437968500491 37.50949720256274, 126.9428055589392 37.50985532557275, 126.9417141715629 37.50938867440667, 126.9402406921176 37.51324230335057, 126.939133257101 37.51419260967873, 126.9384822055998 37.51678990985248, 126.9396322016647 37.51700745173675, 126.942963174707 37.51776431964156, 126.9456341858428 37.51866246584442, 126.9504023930373 37.52002668967632, 126.9514213993267 37.51918635737942, 126.9534208371022 37.51753826503405, 126.9571981610347 37.51541394716001)))"
317,서울특별시,동작구,사당2동,11590630,28471,13751,14720,"MULTIPOLYGON (((126.9801379051013 37.51211780751312, 126.9802974007584 37.5048411843747, 126.9803159313609 37.50400413123089, 126.9803259510256 37.50394928541216, 126.9803915951203 37.50359660031162, 126.980445180882 37.5033096232825, 126.9807038874525 37.50274373640521, 126.981149473721 37.502289584518, 126.9862000251915 37.4990374714722, 126.9869473244186 37.49863173752048, 126.9878425016231 37.4986081314519, 126.9877476109485 37.49823523403149, 126.9862491125148 37.498576875017, 126.9847664869855 37.49927787962328, 126.9834880294342 37.49754630098268, 126.9834398044866 37.49746384124858, 126.9833604408782 37.49732634363158, 126.9832448672641 37.49712610631634, 126.983077757187 37.49675945107592, 126.9830400895135 37.49667678498616, 126.9829606464679 37.49650180829037, 126.9829175161619 37.49640584125234, 126.9829001998747 37.49635281069553, 126.982778132061 37.49524022714131, 126.9827713872636 37.49503964549882, 126.982764971979 37.49484131868661, 126.9827472630333 37.49428595961953, 126.982744573428 37.49419698381431, 126.9827384278102 37.49398040475325, 126.9826515615954 37.49089174580023, 126.9820829814068 37.48538655525137, 126.9820701724793 37.48480590653122, 126.9817921398784 37.48485432071491, 126.9791764301597 37.48439117925221, 126.9785782578113 37.48676253411581, 126.9780154345407 37.48676791764983, 126.9767141252598 37.48708879093308, 126.9766194194934 37.48713918552295, 126.9764935966491 37.48723890421982, 126.9757180920524 37.48804221289591, 126.9736227281905 37.49035052241633, 126.9727021194824 37.49166686601253, 126.9726279296566 37.4927616125547, 126.9724059647908 37.49326432722798, 126.9680584943891 37.49396141080884, 126.9676259503838 37.4938866777504, 126.9669252345375 37.4937467369453, 126.9660168029471 37.49353532206641, 126.9659054545691 37.49350283855194, 126.9658474757083 37.49348498191867, 126.9650379834286 37.49320602645641, 126.9629770643624 37.4945558514855, 126.9611693461596 37.49778011101165, 126.9618070139158 37.49751084421678, 126.9619954821777 37.49743126112588, 126.9620888519366 37.49750958606946, 126.9621276422851 37.49754217998631, 126.965431938458 37.50079876780312, 126.9665228716767 37.50190670724877, 126.9687777634607 37.50351114184685, 126.9696208242318 37.50368618781078, 126.9714231346626 37.50410776346568, 126.9715299960708 37.50416061037776, 126.9716507367657 37.50422032451118, 126.9716796190407 37.50423510974119, 126.9717051831345 37.50425195324293, 126.9733632171289 37.50535354088191, 126.9742135755984 37.5066090869442, 126.9737614315115 37.50684435538361, 126.9735244226156 37.50696768634415, 126.9735936102657 37.5083920283201, 126.9755930365814 37.51229601135129, 126.9801379051013 37.51211780751312)))"
318,서울특별시,관악구,보라매동,11620525,26688,13016,13672,"MULTIPOLYGON (((126.92986951577 37.49400073499751, 126.9311154700311 37.49341860489839, 126.9334516467208 37.49302084129663, 126.9361217357496 37.49240492002553, 126.9391468225295 37.49158331202649, 126.9395092087006 37.49087629868787, 126.9389895030066 37.4894541146039, 126.9387291657497 37.48851672864635, 126.9386893484029 37.48828217310242, 126.9386835662244 37.48824615443959, 126.9386792219369 37.48821902998955, 126.9389161401586 37.48782919172869, 126.9391018110123 37.48786500096699, 126.9391959098969 37.48794994991709, 126.9392406826574 37.4879845221753, 126.9393765535701 37.48808939093919, 126.9396378377319 37.48803429570553, 126.9401421975332 37.48770756437764, 126.9393291347613 37.48620869204466, 126.9349099272701 37.48639722005652, 126.9273349725213 37.48953690233276, 126.9243009287529 37.48996491069668, 126.9248812018461 37.49089729754878, 126.9258274318041 37.4926061653232, 126.926523362188 37.49393116863888, 126.9265504240686 37.49400540136513, 126.9265707567631 37.4940582582179, 126.9266006791538 37.4941257500562, 126.9268285748417 37.49437360212252, 126.927365907951 37.4949305408134, 126.9274032361827 37.49494874886246, 126.927721811034 37.49498860018031, 126.927805307024 37.49497999107371, 126.928036760102 37.4949461843786, 126.9280997669711 37.49493634916632, 126.9284756241472 37.49478831774087, 126.9285153797444 37.49476710286939, 126.9289200903379 37.49454372104947, 126.9290408217733 37.49447332285067, 126.9291807307874 37.49439062355042, 126.92986951577 37.49400073499751)))"
319,서울특별시,관악구,청림동,11620545,16331,8009,8322,"MULTIPOLYGON (((126.9612379763086 37.49255940112582, 126.9612465395746 37.49242838551737, 126.9610672793939 37.49112969511851, 126.9620668999128 37.48729127546255, 126.9621392330692 37.48647136875792, 126.962148068574 37.48523880042369, 126.961468265552 37.48529767209088, 126.9568942807494 37.48637864478926, 126.9576722659965 37.4873106183607, 126.957707295451 37.4873547194587, 126.9579678902527 37.48768716080296, 126.9580030865443 37.48780450332121, 126.9580591467625 37.48816755616657, 126.958053905208 37.48840301187524, 126.9580479728455 37.48844129237197, 126.9580353986646 37.48851897680653, 126.9580054861835 37.48859632030385, 126.957966236773 37.48869780438579, 126.9571425023241 37.48978691846131, 126.9561064768599 37.49158255811371, 126.9562845517183 37.49157443995303, 126.956713987297 37.49155498942338, 126.9573182182086 37.49178535930284, 126.9573707628801 37.49181117397192, 126.9586758902565 37.49293067843028, 126.9589489656749 37.49379047209877, 126.9591251801317 37.4938656409729, 126.9602272771721 37.49388758212987, 126.9603484423575 37.49385095469889, 126.9611988013529 37.49338826658658, 126.9612143391497 37.49328823271334, 126.9612379763086 37.49255940112582)))"
320,서울특별시,관악구,행운동,11620575,30276,14720,15556,"MULTIPOLYGON (((126.962148068574 37.48523880042369, 126.9614060616772 37.4838202871292, 126.9613942291648 37.48378974292677, 126.9613862712286 37.48375959045055, 126.9613771733559 37.4837086131929, 126.9613448433316 37.48348537950942, 126.9644419136359 37.48021513079799, 126.96532097621 37.47956449986047, 126.9658924577129 37.47922344130743, 126.96682013817 37.47858210900811, 126.9678175488172 37.47779445919247, 126.9682126344067 37.47730387019961, 126.9688018212856 37.47665416121276, 126.969592915783 37.47663743454625, 126.9697661608377 37.47663393697918, 126.9701867668624 37.47662545179693, 126.9704905925551 37.4753683309936, 126.9704319103586 37.47535965199737, 126.9702615828769 37.47534022130679, 126.9700773172047 37.4753238736075, 126.9699119031434 37.47530935883606, 126.969653412227 37.47529544913717, 126.9693903741827 37.47529124413091, 126.9691832627952 37.47529256726699, 126.9689166707294 37.47530714310867, 126.9688796616504 37.47530961864337, 126.9686861086203 37.47532526047093, 126.9685601891746 37.47533934128619, 126.9683408324159 37.47537215547675, 126.9682389291021 37.47538859741086, 126.9680789857792 37.47541604498719, 126.9680365200334 37.47542374070753, 126.9679013372823 37.4754490461167, 126.9672831325704 37.47560625194307, 126.9672307229952 37.47562066274124, 126.9669783624392 37.47572205428855, 126.9667345072359 37.47582010357943, 126.9660816348489 37.4760819297313, 126.9657080514042 37.47623121880733, 126.9641676897773 37.47684167488391, 126.9636479911172 37.47704726061883, 126.9634783746487 37.47695577858588, 126.9623096509974 37.47758924143086, 126.9527652700749 37.48129395760751, 126.9527901182462 37.48137630275203, 126.9563041956444 37.4856649835421, 126.9568942807494 37.48637864478926, 126.961468265552 37.48529767209088, 126.962148068574 37.48523880042369)))"
321,서울특별시,관악구,낙성대동,11620585,17736,8834,8902,"MULTIPOLYGON (((126.9527652700749 37.48129395760751, 126.9623096509974 37.47758924143086, 126.9620120983838 37.47708764133352, 126.9615227595383 37.47623711457939, 126.9613877046279 37.47534742461406, 126.9616439457067 37.47483394736654, 126.9618776045471 37.47455082642788, 126.962438328816 37.47373313198749, 126.9633177829135 37.47184521476219, 126.9633796524051 37.47168344463824, 126.9633846958412 37.47147390119275, 126.963344626985 37.47124387224433, 126.9632757282887 37.47099455840813, 126.9628841324768 37.47010944544345, 126.962798808343 37.46998286704461, 126.9626907277521 37.46977618932754, 126.9626803736895 37.46974234121147, 126.9626784331917 37.46971641826163, 126.9627031837954 37.46969000736183, 126.9627536700049 37.46967225566824, 126.9627757993903 37.46964249870104, 126.9628344725448 37.46954248904025, 126.9628897547935 37.46944853910757, 126.9629758486619 37.46934257883732, 126.963007921817 37.46930441675706, 126.9630243843593 37.46926767998769, 126.9630366762693 37.46923694535477, 126.9630462798256 37.46921051602319, 126.9630566418338 37.46918555935559, 126.9630676211065 37.46916047028768, 126.9630827316345 37.46912223110627, 126.9630978776296 37.46908061197998, 126.9631184263994 37.46903558411525, 126.9631423534371 37.46899065992861, 126.9631817484875 37.46891536794831, 126.9631930309895 37.46888977097591, 126.9632126527591 37.46884452616048, 126.9632277550917 37.46880741362214, 126.9632666524604 37.46873052844754, 126.9632843687202 37.46869950745475, 126.9633051000657 37.46867304301341, 126.9633277969723 37.46864687593096, 126.9633470957957 37.4686254300638, 126.9633897675416 37.46858844270923, 126.9634275493794 37.46856712132428, 126.9635174765628 37.46852029381361, 126.9635717022985 37.46849800596681, 126.9636562088053 37.46842557761896, 126.9637271337115 37.46835787379928, 126.9640624262277 37.46793434912497, 126.9641350940441 37.46784256858484, 126.9644661900479 37.46760401907633, 126.9645328510738 37.46755600369926, 126.9652966798644 37.46531274689783, 126.9657228807452 37.46431754773418, 126.9667740920829 37.46348177591224, 126.9672855840757 37.46321029413502, 126.9677963600175 37.46293880689453, 126.9701333254676 37.46126601463933, 126.9703002534636 37.46094452591115, 126.9698333942098 37.46000388853717, 126.9695872025851 37.45954083540818, 126.969426943036 37.45931702871485, 126.9693374983179 37.45924726723266, 126.9692976226811 37.45921617142157, 126.9689645964266 37.45904116305128, 126.9688153605439 37.4589889253776, 126.9687037524376 37.45894985434224, 126.9663905668838 37.45638359947765, 126.9663424229482 37.45630160141059, 126.9657232509761 37.4550335089413, 126.9632912745522 37.45517572807504, 126.9615544671563 37.4555464000535, 126.9596018604345 37.45683544988196, 126.958231487303 37.4578330680889, 126.9576688466117 37.4585335500686, 126.9574656695806 37.45887626186894, 126.95565207694 37.46212296631391, 126.9555039485661 37.46257415003345, 126.9556982098861 37.4643382740711, 126.9559628319326 37.4652701491949, 126.9556351607066 37.46611253961214, 126.953496217247 37.47081002305873, 126.9534613689209 37.47084028188875, 126.9533276480085 37.47095571435167, 126.9531404980817 37.47103146398165, 126.9525349783624 37.47109851545182, 126.9529184772571 37.47210868752303, 126.9529674051071 37.47228962774504, 126.953109135271 37.47281375860658, 126.9531051883607 37.47325766014975, 126.9530965933057 37.47346718656106, 126.9530940352103 37.4735280165175, 126.9525543378993 37.48046035114062, 126.9522600398955 37.4813526889103, 126.9527652700749 37.48129395760751)))"
322,서울특별시,관악구,중앙동,11620615,15782,7547,8235,"MULTIPOLYGON (((126.9563041956444 37.4856649835421, 126.9527901182462 37.48137630275203, 126.9527652700749 37.48129395760751, 126.9522600398955 37.4813526889103, 126.9463372946441 37.48197270241266, 126.9469526335041 37.48693081467593, 126.9563041956444 37.4856649835421)))"
323,서울특별시,관악구,인헌동,11620625,27200,13295,13905,"MULTIPOLYGON (((126.9704905925551 37.4753683309936, 126.9707898035469 37.47500125667605, 126.9715671461702 37.47312984714704, 126.97132055432 37.46980506114102, 126.9712563804626 37.46968413130536, 126.9711806358394 37.46954263016153, 126.9711384886187 37.4694638969106, 126.9708103720047 37.46891748289307, 126.970594974187 37.46856010174122, 126.9703836755224 37.46845549831995, 126.9695342302894 37.46803931517836, 126.9657060865104 37.46678949217462, 126.9645328510738 37.46755600369926, 126.9644661900479 37.46760401907633, 126.9641350940441 37.46784256858484, 126.9640624262277 37.46793434912497, 126.9637271337115 37.46835787379928, 126.9636562088053 37.46842557761896, 126.9635717022985 37.46849800596681, 126.9635174765628 37.46852029381361, 126.9634275493794 37.46856712132428, 126.9633897675416 37.46858844270923, 126.9633470957957 37.4686254300638, 126.9633277969723 37.46864687593096, 126.9633051000657 37.46867304301341, 126.9632843687202 37.46869950745475, 126.9632666524604 37.46873052844754, 126.9632277550917 37.46880741362214, 126.9632126527591 37.46884452616048, 126.9631930309895 37.46888977097591, 126.9631817484875 37.46891536794831, 126.9631423534371 37.46899065992861, 126.9631184263994 37.46903558411525, 126.9630978776296 37.46908061197998, 126.9630827316345 37.46912223110627, 126.9630676211065 37.46916047028768, 126.9630566418338 37.46918555935559, 126.9630462798256 37.46921051602319, 126.9630366762693 37.46923694535477, 126.9630243843593 37.46926767998769, 126.963007921817 37.46930441675706, 126.9629758486619 37.46934257883732, 126.9628897547935 37.46944853910757, 126.9628344725448 37.46954248904025, 126.9627757993903 37.46964249870104, 126.9627536700049 37.46967225566824, 126.9627031837954 37.46969000736183, 126.9626784331917 37.46971641826163, 126.9626803736895 37.46974234121147, 126.9626907277521 37.46977618932754, 126.962798808343 37.46998286704461, 126.9628841324768 37.47010944544345, 126.9632757282887 37.47099455840813, 126.963344626985 37.47124387224433, 126.9633846958412 37.47147390119275, 126.9633796524051 37.47168344463824, 126.9633177829135 37.47184521476219, 126.962438328816 37.47373313198749, 126.9618776045471 37.47455082642788, 126.9616439457067 37.47483394736654, 126.9613877046279 37.47534742461406, 126.9615227595383 37.47623711457939, 126.9620120983838 37.47708764133352, 126.9623096509974 37.47758924143086, 126.9634783746487 37.47695577858588, 126.9636479911172 37.47704726061883, 126.9641676897773 37.47684167488391, 126.9657080514042 37.47623121880733, 126.9660816348489 37.4760819297313, 126.9667345072359 37.47582010357943, 126.9669783624392 37.47572205428855, 126.9672307229952 37.47562066274124, 126.9672831325704 37.47560625194307, 126.9679013372823 37.4754490461167, 126.9680365200334 37.47542374070753, 126.9680789857792 37.47541604498719, 126.9682389291021 37.47538859741086, 126.9683408324159 37.47537215547675, 126.9685601891746 37.47533934128619, 126.9686861086203 37.47532526047093, 126.9688796616504 37.47530961864337, 126.9689166707294 37.47530714310867, 126.9691832627952 37.47529256726699, 126.9693903741827 37.47529124413091, 126.969653412227 37.47529544913717, 126.9699119031434 37.47530935883606, 126.9700773172047 37.4753238736075, 126.9702615828769 37.47534022130679, 126.9704319103586 37.47535965199737, 126.9704905925551 37.4753683309936)))"
324,서울특별시,관악구,남현동,11620630,19032,9148,9884,"MULTIPOLYGON (((126.9817228223633 37.47636480563454, 126.981766439354 37.47583403693234, 126.981860324741 37.474698129272, 126.9819492496233 37.47442317146226, 126.9825375417371 37.47277053491663, 126.9825533140157 37.47274324767584, 126.9826512774708 37.47257386018693, 126.9832349577435 37.47157026974844, 126.9837809856857 37.47079861232137, 126.9845276239683 37.46974495320689, 126.985429038496 37.46897603644689, 126.9866654940081 37.46800569005608, 126.9867109733556 37.46796983313727, 126.9868629934932 37.46784996956239, 126.987131088415 37.46751421602703, 126.987389082213 37.4671909262415, 126.9875915775051 37.46693711919738, 126.9878072688463 37.46640509320054, 126.9881638302608 37.4655244296988, 126.9882344549443 37.46387298857078, 126.9880215242642 37.46276226323842, 126.9879211815878 37.46224129135372, 126.9876392329454 37.4613037783615, 126.9874672782277 37.46040934010766, 126.9876394888408 37.45940190298298, 126.9886204638784 37.45813532321736, 126.9868361684551 37.45740752974346, 126.9823557466625 37.45515824078382, 126.978660607673 37.45189933174718, 126.9740569513284 37.44765379745638, 126.9739831458347 37.447599378097, 126.9708122231129 37.44746129495066, 126.9686971968018 37.44679042965236, 126.9688141275956 37.44684164799252, 126.9694934404783 37.44740242751499, 126.9697431629623 37.44786099067503, 126.9698323665023 37.44873684105765, 126.9698475320739 37.44909182129243, 126.9698085825898 37.44930346717423, 126.969726600339 37.44950590632023, 126.9677112879664 37.45230684889821, 126.9657232509761 37.4550335089413, 126.9663424229482 37.45630160141059, 126.9663905668838 37.45638359947765, 126.9687037524376 37.45894985434224, 126.9688153605439 37.4589889253776, 126.9689645964266 37.45904116305128, 126.9692976226811 37.45921617142157, 126.9693374983179 37.45924726723266, 126.969426943036 37.45931702871485, 126.9695872025851 37.45954083540818, 126.9698333942098 37.46000388853717, 126.9703002534636 37.46094452591115, 126.9701333254676 37.46126601463933, 126.9677963600175 37.46293880689453, 126.9672855840757 37.46321029413502, 126.9667740920829 37.46348177591224, 126.9657228807452 37.46431754773418, 126.9652966798644 37.46531274689783, 126.9645328510738 37.46755600369926, 126.9657060865104 37.46678949217462, 126.9695342302894 37.46803931517836, 126.9703836755224 37.46845549831995, 126.970594974187 37.46856010174122, 126.9708103720047 37.46891748289307, 126.9711384886187 37.4694638969106, 126.9711806358394 37.46954263016153, 126.9712563804626 37.46968413130536, 126.97132055432 37.46980506114102, 126.9715671461702 37.47312984714704, 126.9707898035469 37.47500125667605, 126.9704905925551 37.4753683309936, 126.970945905803 37.47547672478279, 126.971517860694 37.47561287589228, 126.9719638498903 37.47571852628742, 126.972367501544 37.47581384564384, 126.9727000668451 37.47587392409821, 126.973448332394 37.476007951995, 126.9748306321371 37.47625521882692, 126.9749414854638 37.47627373869589, 126.9751518691319 37.47630589653419, 126.9769186186389 37.47657207016604, 126.9772741156172 37.47657927604376, 126.9793880695864 37.47662015792076, 126.9817228223633 37.47636480563454)))"
325,서울특별시,관악구,서원동,11620645,24095,12256,11839,"MULTIPOLYGON (((126.9378545403183 37.48410723277187, 126.9378580905541 37.48364079160876, 126.9378491806535 37.48331958640626, 126.9370652948711 37.4822680840597, 126.9367458417538 37.48197806840194, 126.9361884832615 37.48164303420425, 126.9357356192547 37.48142793993578, 126.9356487481597 37.48131596843911, 126.9356425768424 37.48110186641565, 126.9357329858965 37.48082304847068, 126.9369519071237 37.47957580339058, 126.9371479233504 37.47945392725763, 126.938191115275 37.47919524487617, 126.9394786498026 37.4781152229126, 126.9382534774264 37.47728578776884, 126.9382281632091 37.47726876242902, 126.9352165536637 37.47627981547672, 126.9302106285515 37.47534313998459, 126.9318111585836 37.47875452881546, 126.9266610062894 37.48383368415271, 126.9342013138742 37.48483673464584, 126.9378545403183 37.48410723277187)))"
326,서울특별시,관악구,신원동,11620655,19892,10025,9867,"MULTIPOLYGON (((126.9302106285515 37.47534313998459, 126.9294120040174 37.47504845542565, 126.9265919893748 37.4744603100538, 126.9241763227551 37.47716512228291, 126.9230089946861 37.47887218719628, 126.9215737114856 37.48312159504654, 126.9261806579414 37.48378064359188, 126.9266610062894 37.48383368415271, 126.9318111585836 37.47875452881546, 126.9302106285515 37.47534313998459)))"
327,서울특별시,관악구,서림동,11620665,24485,13374,11111,"MULTIPOLYGON (((126.946545461534 37.47274596969802, 126.9467491421393 37.47242360578501, 126.9467906678811 37.47004771598235, 126.9458427066667 37.46959021431993, 126.9454464572667 37.46945878479078, 126.9452218043964 37.46962161556787, 126.9449476466605 37.46982033989371, 126.9447416882014 37.46997052133526, 126.9368080258478 37.47105502234714, 126.9363642845123 37.47113177546763, 126.9362804448667 37.47114764505716, 126.9362482022742 37.47115375477808, 126.9350158661176 37.47138898247649, 126.9341391834723 37.47179490592321, 126.9335330083407 37.47306967827799, 126.9294438297315 37.47458006027212, 126.9294120040174 37.47504845542565, 126.9302106285515 37.47534313998459, 126.9352165536637 37.47627981547672, 126.9382281632091 37.47726876242902, 126.9382534774264 37.47728578776884, 126.9394786498026 37.4781152229126, 126.9401074426264 37.4772921449695, 126.9411646009782 37.47649512957767, 126.9429040394447 37.47527749528923, 126.9430908905915 37.47514880573022, 126.9431384959676 37.47511635582544, 126.9432505785725 37.47506055806517, 126.9432970587699 37.47508555543728, 126.9433377871954 37.47512180169838, 126.943605314466 37.47540724234249, 126.9444942612377 37.47473064723037, 126.9460436717898 37.47324534213411, 126.946545461534 37.47274596969802)))"
328,서울특별시,관악구,신사동,11620685,26161,13196,12965,"MULTIPOLYGON (((126.9261806579414 37.48378064359188, 126.9215737114856 37.48312159504654, 126.914538719854 37.48181377771049, 126.9133235005701 37.48724737673505, 126.9138151814709 37.48752633178206, 126.9159684432826 37.48876242670654, 126.9188907014525 37.48956214246951, 126.9197872090084 37.48944373904263, 126.9200246899151 37.4893615296761, 126.9209541132486 37.48902808014812, 126.9216535947578 37.48853350707074, 126.9221532922259 37.48809203416798, 126.9223398492501 37.48782817301827, 126.922923811561 37.48699952539533, 126.9232351504739 37.48655755118445, 126.9232592534497 37.4865231604064, 126.9232904847169 37.48647965564832, 126.9251555055589 37.48462518930303, 126.9261806579414 37.48378064359188)))"
329,서울특별시,관악구,신림동,11620695,22574,11376,11198,"MULTIPOLYGON (((126.9349099272701 37.48639722005652, 126.9342013138742 37.48483673464584, 126.9266610062894 37.48383368415271, 126.9261806579414 37.48378064359188, 126.9251555055589 37.48462518930303, 126.9232904847169 37.48647965564832, 126.9232592534497 37.4865231604064, 126.9232351504739 37.48655755118445, 126.922923811561 37.48699952539533, 126.9223398492501 37.48782817301827, 126.9221532922259 37.48809203416798, 126.9216535947578 37.48853350707074, 126.9209541132486 37.48902808014812, 126.9200246899151 37.4893615296761, 126.9197872090084 37.48944373904263, 126.9188907014525 37.48956214246951, 126.9243009287529 37.48996491069668, 126.9273349725213 37.48953690233276, 126.9349099272701 37.48639722005652)))"
330,서울특별시,관악구,난향동,11620715,16436,8110,8326,"MULTIPOLYGON (((126.9229796110085 37.4634608647314, 126.922843387845 37.46298806875911, 126.9232414182123 37.46195795445619, 126.9236298557216 37.46097849334566, 126.9240635525994 37.45990235506164, 126.9240862478337 37.4597075463846, 126.9229593146776 37.4578351050277, 126.9224684372865 37.4572479499552, 126.918410725052 37.45716267788382, 126.9148338641404 37.45766757101352, 126.9141512833226 37.45809259685306, 126.9139625782421 37.45864492988382, 126.9128594085021 37.46397432171825, 126.913030632375 37.46440106482278, 126.9134807289906 37.46495763590994, 126.9137488246472 37.4652823290543, 126.9150827947675 37.46615537064353, 126.9189971997684 37.46657421868667, 126.9229796110085 37.4634608647314)))"
331,서울특별시,관악구,조원동,11620725,19671,10063,9608,"MULTIPOLYGON (((126.914538719854 37.48181377771049, 126.9097237213896 37.48094931346144, 126.9085463260537 37.48072596301455, 126.907497403291 37.48053142251079, 126.9065515927928 37.48035656974228, 126.9053094415572 37.48012800529317, 126.9038607795251 37.47986189908314, 126.9024723447659 37.47960701229682, 126.9021187151585 37.47954212836024, 126.9006741413445 37.47932637164095, 126.899468525752 37.48034441659667, 126.903226979492 37.48498628253719, 126.9051330132761 37.48496548315135, 126.9056115187601 37.48497803174432, 126.9059634901976 37.48498881555482, 126.9067036735653 37.48516491929299, 126.9074629083846 37.48534674742868, 126.9077667789163 37.48542446270434, 126.9087178142574 37.48571135975195, 126.908992746886 37.48579494810849, 126.9090817641353 37.48582246110652, 126.9092261732701 37.48586709738408, 126.9103792162795 37.48622663984582, 126.9104158878683 37.4862380898109, 126.9111549597577 37.4864693682276, 126.9132388855121 37.48720530124272, 126.9133235005701 37.48724737673505, 126.914538719854 37.48181377771049)))"
332,서울특별시,관악구,대학동,11620735,24603,14584,10019,"MULTIPOLYGON (((126.9525349783624 37.47109851545182, 126.9531404980817 37.47103146398165, 126.9533276480085 37.47095571435167, 126.9534613689209 37.47084028188875, 126.953496217247 37.47081002305873, 126.9556351607066 37.46611253961214, 126.9559628319326 37.4652701491949, 126.9556982098861 37.4643382740711, 126.9555039485661 37.46257415003345, 126.95565207694 37.46212296631391, 126.9574656695806 37.45887626186894, 126.9576688466117 37.4585335500686, 126.958231487303 37.4578330680889, 126.9596018604345 37.45683544988196, 126.9615544671563 37.4555464000535, 126.9632912745522 37.45517572807504, 126.9657232509761 37.4550335089413, 126.9677112879664 37.45230684889821, 126.969726600339 37.44950590632023, 126.9698085825898 37.44930346717423, 126.9698475320739 37.44909182129243, 126.9698323665023 37.44873684105765, 126.9697431629623 37.44786099067503, 126.9694934404783 37.44740242751499, 126.9688141275956 37.44684164799252, 126.9686971968018 37.44679042965236, 126.9686080242227 37.4467900296523, 126.96847816389 37.44678944570685, 126.9682721613249 37.44676660600383, 126.9681075040072 37.44674834346783, 126.9655663122162 37.44609691093394, 126.9654091410151 37.44604211824498, 126.9645616320769 37.44569012967655, 126.9645028223226 37.44564733684985, 126.9644105084297 37.44558015357386, 126.964355381761 37.44548523341985, 126.9643232524574 37.44542990716038, 126.9639925224085 37.44485047971795, 126.9638273757729 37.44422095570769, 126.9638328078683 37.44395733203928, 126.9638519656382 37.44384700084965, 126.9638662981848 37.44376633061368, 126.9638725765971 37.44373104451873, 126.963912809079 37.44359341733181, 126.9639623809005 37.44342386016943, 126.9640498565887 37.44304681119041, 126.9640834365712 37.4427957079587, 126.9641118897099 37.44247247225463, 126.9640981324199 37.44229962720235, 126.9640891888348 37.44218731261137, 126.9639828429822 37.44204035763322, 126.963106668027 37.44106065302599, 126.9630354199052 37.44102117675872, 126.9627519187964 37.44087313446819, 126.9622666823791 37.44065572688515, 126.958366968661 37.43953374813941, 126.9582385658127 37.43950837211572, 126.9562746369048 37.43918498657516, 126.9557975667769 37.43911745823523, 126.9553490148976 37.43910525178539, 126.9549803077712 37.43913453302031, 126.9549333468737 37.43913826354541, 126.9545605346076 37.43920527281198, 126.9542227648152 37.4393096240295, 126.9541442630098 37.43933355240583, 126.9540443284133 37.43936400856851, 126.9537576160208 37.43944380673546, 126.9534666951283 37.43950827956417, 126.9533592005308 37.43953210129351, 126.9531768027811 37.43954815817943, 126.9527502214029 37.43952702985226, 126.9517318885447 37.43946372181576, 126.9483235836503 37.43908957016222, 126.9479035921025 37.43894565945651, 126.9468434024045 37.4385505755491, 126.9413393307039 37.43648224149731, 126.9408952578235 37.4362502936751, 126.9406346562018 37.43614315028992, 126.9395275736702 37.43595763292997, 126.9394934809437 37.43595925236296, 126.9394335673368 37.43596282066896, 126.9393601860802 37.43604584890166, 126.9382822222062 37.43753060519889, 126.9379043945144 37.43856050295946, 126.9378713723991 37.43891300481764, 126.9378873574268 37.43951586837375, 126.9379193250353 37.43958700285418, 126.9379401826673 37.43963217026533, 126.9379856466295 37.43969210635693, 126.9380213435631 37.43973846651153, 126.9380807895047 37.43977668757271, 126.9381837625206 37.43984289556175, 126.9383304987995 37.43996753056434, 126.9384285174624 37.44018094366105, 126.9384685176079 37.4403118315434, 126.938366738282 37.44050626800102, 126.9373801831558 37.44176686601926, 126.937237598491 37.44193744638478, 126.9356029006498 37.44322757513314, 126.9336425543837 37.44430438144445, 126.9319214416579 37.44523015934779, 126.9318806150963 37.44524397930723, 126.9316621738658 37.44531792251745, 126.9315522305882 37.44537485569263, 126.9311811416278 37.44557925715652, 126.9310345949816 37.44571037614477, 126.9310057358281 37.44578910649745, 126.9308825015865 37.44694676481615, 126.9308861154358 37.44758900337786, 126.930914305052 37.44769279586086, 126.9310257172824 37.44782068134244, 126.9338302656054 37.44986781831386, 126.935511348839 37.45176159158375, 126.9360057534419 37.45252484621512, 126.9383597725532 37.45665528221646, 126.9385270216587 37.45753715817199, 126.9385384883308 37.45779860756461, 126.9385959981308 37.45927598717176, 126.9382714958854 37.46005174769413, 126.9375987504414 37.46127001413022, 126.9342893842118 37.46499486414555, 126.9322685113086 37.4659620214523, 126.9316915968573 37.46580263690495, 126.9314375405371 37.46577439199459, 126.9314031870794 37.46627671698766, 126.9314000017314 37.46632402306914, 126.9314028170903 37.46642336650588, 126.9314650075339 37.46678839210338, 126.9315744356664 37.46718228200166, 126.932445742589 37.46879089089006, 126.9341391834723 37.47179490592321, 126.9350158661176 37.47138898247649, 126.9362482022742 37.47115375477808, 126.9362804448667 37.47114764505716, 126.9363642845123 37.47113177546763, 126.9368080258478 37.47105502234714, 126.9447416882014 37.46997052133526, 126.9449476466605 37.46982033989371, 126.9452218043964 37.46962161556787, 126.9454464572667 37.46945878479078, 126.9458427066667 37.46959021431993, 126.9467906678811 37.47004771598235, 126.9467491421393 37.47242360578501, 126.946545461534 37.47274596969802, 126.9475456596632 37.47248677727674, 126.9483756591292 37.4725044467389, 126.9484786703272 37.47250042080053, 126.9491477339827 37.47247424673611, 126.9496872190017 37.47224411052866, 126.9498688239554 37.47216663701877, 126.9499278267314 37.47209679581534, 126.9502887889683 37.47166946431551, 126.9504639720615 37.47156970451722, 126.9506145703713 37.47148394725467, 126.9509929512073 37.47126944618185, 126.9525349783624 37.47109851545182)))"
333,서울특별시,관악구,은천동,11620605,35505,17398,18107,"MULTIPOLYGON (((126.9433879771593 37.49208221718774, 126.9449749488992 37.49153419182096, 126.94521795436 37.49123969176631, 126.945268237983 37.4911784382184, 126.9456078982235 37.49075526724594, 126.94610236302 37.4901368444818, 126.9461358009527 37.48928274805731, 126.9464970160995 37.48782439246632, 126.9465408972253 37.48767194323018, 126.9465695724559 37.48757235226235, 126.9466941676863 37.48735773582939, 126.9469526335041 37.48693081467593, 126.9463372946441 37.48197270241266, 126.9430050113606 37.48231428597648, 126.9378545403183 37.48410723277187, 126.9342013138742 37.48483673464584, 126.9349099272701 37.48639722005652, 126.9393291347613 37.48620869204466, 126.9401421975332 37.48770756437764, 126.9396378377319 37.48803429570553, 126.9393765535701 37.48808939093919, 126.9392406826574 37.4879845221753, 126.9391959098969 37.48794994991709, 126.9391018110123 37.48786500096699, 126.9389161401586 37.48782919172869, 126.9386792219369 37.48821902998955, 126.9386835662244 37.48824615443959, 126.9386893484029 37.48828217310242, 126.9387291657497 37.48851672864635, 126.9389895030066 37.4894541146039, 126.9395092087006 37.49087629868787, 126.9416462019981 37.49225195182756, 126.9428290000847 37.49223731964081, 126.9433879771593 37.49208221718774)))"
334,서울특별시,관악구,성현동,11620565,32323,15678,16645,"MULTIPOLYGON (((126.9561064768599 37.49158255811371, 126.9571425023241 37.48978691846131, 126.957966236773 37.48869780438579, 126.9580054861835 37.48859632030385, 126.9580353986646 37.48851897680653, 126.9580479728455 37.48844129237197, 126.958053905208 37.48840301187524, 126.9580591467625 37.48816755616657, 126.9580030865443 37.48780450332121, 126.9579678902527 37.48768716080296, 126.957707295451 37.4873547194587, 126.9576722659965 37.4873106183607, 126.9568942807494 37.48637864478926, 126.9563041956444 37.4856649835421, 126.9469526335041 37.48693081467593, 126.9466941676863 37.48735773582939, 126.9465695724559 37.48757235226235, 126.9465408972253 37.48767194323018, 126.9464970160995 37.48782439246632, 126.9461358009527 37.48928274805731, 126.94610236302 37.4901368444818, 126.9456078982235 37.49075526724594, 126.945268237983 37.4911784382184, 126.94521795436 37.49123969176631, 126.9449749488992 37.49153419182096, 126.9433879771593 37.49208221718774, 126.9473924874278 37.49390934396739, 126.9476797745938 37.49373974698315, 126.948517627446 37.49367688961615, 126.9512468198595 37.49241079747357, 126.9533960659656 37.49115886118762, 126.9534563528154 37.49113378763044, 126.9540410230345 37.49103903447582, 126.9548042761398 37.49117776285546, 126.9561064768599 37.49158255811371)))"
335,서울특별시,관악구,청룡동,11620595,33607,16158,17449,"MULTIPOLYGON (((126.9463372946441 37.48197270241266, 126.9522600398955 37.4813526889103, 126.9525543378993 37.48046035114062, 126.9530940352103 37.4735280165175, 126.9530965933057 37.47346718656106, 126.9531051883607 37.47325766014975, 126.953109135271 37.47281375860658, 126.9529674051071 37.47228962774504, 126.9529184772571 37.47210868752303, 126.9525349783624 37.47109851545182, 126.9509929512073 37.47126944618185, 126.9506145703713 37.47148394725467, 126.9504639720615 37.47156970451722, 126.9502887889683 37.47166946431551, 126.9499278267314 37.47209679581534, 126.9498688239554 37.47216663701877, 126.9496872190017 37.47224411052866, 126.9491477339827 37.47247424673611, 126.9484786703272 37.47250042080053, 126.9483756591292 37.4725044467389, 126.9475456596632 37.47248677727674, 126.946545461534 37.47274596969802, 126.9460436717898 37.47324534213411, 126.9444942612377 37.47473064723037, 126.943605314466 37.47540724234249, 126.9433377871954 37.47512180169838, 126.9432970587699 37.47508555543728, 126.9432505785725 37.47506055806517, 126.9431384959676 37.47511635582544, 126.9430908905915 37.47514880573022, 126.9429040394447 37.47527749528923, 126.9411646009782 37.47649512957767, 126.9401074426264 37.4772921449695, 126.9394786498026 37.4781152229126, 126.938191115275 37.47919524487617, 126.9371479233504 37.47945392725763, 126.9369519071237 37.47957580339058, 126.9357329858965 37.48082304847068, 126.9356425768424 37.48110186641565, 126.9356487481597 37.48131596843911, 126.9357356192547 37.48142793993578, 126.9361884832615 37.48164303420425, 126.9367458417538 37.48197806840194, 126.9370652948711 37.4822680840597, 126.9378491806535 37.48331958640626, 126.9378580905541 37.48364079160876, 126.9378545403183 37.48410723277187, 126.9430050113606 37.48231428597648, 126.9463372946441 37.48197270241266)))"
336,서울특별시,관악구,난곡동,11620775,29173,14693,14480,"MULTIPOLYGON (((126.9265919893748 37.4744603100538, 126.9267010122394 37.47294884565834, 126.9264957446124 37.47187635986979, 126.9260137083294 37.4679958203922, 126.9246908497007 37.46656371454196, 126.9241039522175 37.46615348608077, 126.9239072412777 37.46599929603929, 126.9234350465396 37.46562720109348, 126.9233604901432 37.46545590338808, 126.9232469367131 37.46519499137499, 126.9229469206584 37.46450511293367, 126.9229431951193 37.46440721604721, 126.922934579062 37.46418056302253, 126.9229796110085 37.4634608647314, 126.9189971997684 37.46657421868667, 126.9150827947675 37.46615537064353, 126.91428206853 37.46941094468684, 126.9144366391095 37.47007308290193, 126.9150012685663 37.47153833430749, 126.9177279563743 37.47394158357925, 126.9177966806298 37.47400043391202, 126.9195161645035 37.47457562306143, 126.9207487714701 37.47525552057744, 126.9226828904672 37.47632289654175, 126.9235968197095 37.47683703251668, 126.9241763227551 37.47716512228291, 126.9265919893748 37.4744603100538)))"
337,서울특별시,관악구,삼성동,11620745,25454,12784,12670,"MULTIPOLYGON (((126.9341391834723 37.47179490592321, 126.932445742589 37.46879089089006, 126.9315744356664 37.46718228200166, 126.9314650075339 37.46678839210338, 126.9314028170903 37.46642336650588, 126.9314000017314 37.46632402306914, 126.9314031870794 37.46627671698766, 126.9314375405371 37.46577439199459, 126.9316915968573 37.46580263690495, 126.9322685113086 37.4659620214523, 126.9342893842118 37.46499486414555, 126.9375987504414 37.46127001413022, 126.9382714958854 37.46005174769413, 126.9385959981308 37.45927598717176, 126.9385384883308 37.45779860756461, 126.9385270216587 37.45753715817199, 126.9383597725532 37.45665528221646, 126.9360057534419 37.45252484621512, 126.935511348839 37.45176159158375, 126.9338302656054 37.44986781831386, 126.9310257172824 37.44782068134244, 126.9287494338708 37.45019265142709, 126.9270717555706 37.45168980086971, 126.9253017306146 37.45288001830183, 126.9231840567649 37.45442793043426, 126.9230559836039 37.45463461842495, 126.9226384280472 37.45554295431342, 126.9224300064835 37.45673173284288, 126.9225089097932 37.45694731844073, 126.9224684372865 37.4572479499552, 126.9229593146776 37.4578351050277, 126.9240862478337 37.4597075463846, 126.9240635525994 37.45990235506164, 126.9236298557216 37.46097849334566, 126.9232414182123 37.46195795445619, 126.922843387845 37.46298806875911, 126.9229796110085 37.4634608647314, 126.922934579062 37.46418056302253, 126.9229431951193 37.46440721604721, 126.9229469206584 37.46450511293367, 126.9232469367131 37.46519499137499, 126.9233604901432 37.46545590338808, 126.9234350465396 37.46562720109348, 126.9239072412777 37.46599929603929, 126.9241039522175 37.46615348608077, 126.9246908497007 37.46656371454196, 126.9260137083294 37.4679958203922, 126.9264957446124 37.47187635986979, 126.9267010122394 37.47294884565834, 126.9265919893748 37.4744603100538, 126.9294120040174 37.47504845542565, 126.9294438297315 37.47458006027212, 126.9335330083407 37.47306967827799, 126.9341391834723 37.47179490592321)))"
338,서울특별시,관악구,미성동,11620765,32929,16122,16807,"MULTIPOLYGON (((126.9241763227551 37.47716512228291, 126.9235968197095 37.47683703251668, 126.9226828904672 37.47632289654175, 126.9207487714701 37.47525552057744, 126.9195161645035 37.47457562306143, 126.9177966806298 37.47400043391202, 126.9177279563743 37.47394158357925, 126.9150012685663 37.47153833430749, 126.9144366391095 37.47007308290193, 126.91428206853 37.46941094468684, 126.9150827947675 37.46615537064353, 126.9137488246472 37.4652823290543, 126.9124361728704 37.46567691438344, 126.9123996033828 37.46601023914257, 126.9118639490203 37.466415624186, 126.911617354111 37.46662715342153, 126.9101252449177 37.46907253761359, 126.9090072091013 37.47121331130845, 126.9086356383151 37.4720835165265, 126.9082284708289 37.47262567309232, 126.9098443469567 37.47324555173434, 126.9098816980279 37.47326038535456, 126.9107212565329 37.47363976575863, 126.9108098511298 37.47369992254787, 126.9108484899583 37.47372940935475, 126.9108723268727 37.47375431555722, 126.910907456927 37.47379137879275, 126.9109340131264 37.47381997157465, 126.9109577528336 37.47385727094998, 126.9113468021257 37.47473606001092, 126.9116395510558 37.4755191667737, 126.9119375780869 37.4769053614489, 126.9118633852895 37.47726328185676, 126.9116216363534 37.47816569016155, 126.9112916399684 37.47814939841609, 126.911259169081 37.47814360313711, 126.9106484845194 37.47810087632084, 126.9094851576208 37.47820235192579, 126.9092400452775 37.47839615513239, 126.9088243242033 37.47886491694283, 126.9088228423749 37.47944264349188, 126.9097237213896 37.48094931346144, 126.914538719854 37.48181377771049, 126.9215737114856 37.48312159504654, 126.9230089946861 37.47887218719628, 126.9241763227551 37.47716512228291)))"
339,서울특별시,서초구,서초1동,11650510,21708,10487,11221,"MULTIPOLYGON (((127.0270147928412 37.48050810722698, 127.0255129091646 37.48079840702298, 127.0245252976012 37.48059276969647, 127.024439701192 37.48053797936051, 127.0241197158027 37.48033310947108, 127.0240408691743 37.47935976301049, 127.0217793608467 37.47752943886118, 127.0208367871925 37.47711472529081, 127.0202751209363 37.47686760023948, 127.0198319417723 37.47687481366636, 127.0193310792079 37.47869240120247, 127.0193456408432 37.4800547286554, 127.0187347830619 37.48161826260258, 127.0179922484115 37.48222990984856, 127.0173337176217 37.4832620486871, 127.0152938359646 37.48660450449299, 127.0149343287959 37.4872081202378, 127.0145839105151 37.48837388820654, 127.0140304414249 37.49152411938311, 127.0139595523692 37.49198438637922, 127.0139322863942 37.49216142827665, 127.0139034843588 37.49327836164196, 127.0140210482701 37.49357967665529, 127.0157623700279 37.49431858110463, 127.021276880188 37.49600985787428, 127.0224987362947 37.49267070209164, 127.0249625658637 37.48632717245842, 127.0257209515791 37.48418614420528, 127.0270147928412 37.48050810722698)))"
340,서울특별시,서초구,서초2동,11650520,18675,8949,9726,"MULTIPOLYGON (((127.0316232575204 37.48954007672874, 127.0337774785239 37.48509925625063, 127.0339679429088 37.48479724859385, 127.0336295469175 37.48401346955486, 127.0343590003938 37.48286955361115, 127.0343629208344 37.48280647375728, 127.0343645164419 37.48277718579683, 127.0341323200084 37.48244318042338, 127.0339279234372 37.48221195113485, 127.0325226960076 37.48100774987677, 127.0304119726419 37.4802005433929, 127.0294079824593 37.48045569481998, 127.02865560373 37.48105660802032, 127.0279117817392 37.48085646547389, 127.0270147928412 37.48050810722698, 127.0257209515791 37.48418614420528, 127.0249625658637 37.48632717245842, 127.0224987362947 37.49267070209164, 127.021276880188 37.49600985787428, 127.0276351080783 37.49796430342111, 127.0316232575204 37.48954007672874)))"
341,서울특별시,서초구,서초3동,11650530,31067,15196,15871,"MULTIPOLYGON (((127.0157623700279 37.49431858110463, 127.0140210482701 37.49357967665529, 127.0139034843588 37.49327836164196, 127.0139322863942 37.49216142827665, 127.0139595523692 37.49198438637922, 127.0140304414249 37.49152411938311, 127.0145839105151 37.48837388820654, 127.0149343287959 37.4872081202378, 127.0152938359646 37.48660450449299, 127.0173337176217 37.4832620486871, 127.0179922484115 37.48222990984856, 127.0187347830619 37.48161826260258, 127.0193456408432 37.4800547286554, 127.0193310792079 37.47869240120247, 127.0198319417723 37.47687481366636, 127.0180706829848 37.47660399466169, 127.0168398842667 37.47596688807879, 127.0155060934365 37.47475585480396, 127.0150224601761 37.47423108070215, 127.014995242126 37.47420072377637, 127.0135944039 37.47317625041693, 127.0103100761861 37.47226020215308, 127.009089387811 37.47485330672691, 127.0066406136884 37.47821530986733, 127.005416022872 37.47901579789404, 127.0041017912628 37.47855397521132, 127.0039572076008 37.47877048815107, 127.0038415571734 37.47894384806325, 127.0035809137252 37.47934047879561, 127.0033074208222 37.47975733552192, 127.0031681347225 37.479974203212, 127.0029488527445 37.48031692473237, 127.002670308565 37.48085318893781, 127.0029638997371 37.48127421508983, 127.0021516263079 37.48229539968448, 127.0018854649892 37.48279682233944, 127.0008286302641 37.48365649248711, 127.0008285911282 37.48418158239238, 127.000828674276 37.48421498714998, 127.0008289855104 37.48433481527865, 127.000828858531 37.48446100515567, 127.000638587277 37.48500777732822, 127.0005852681726 37.48515963391874, 127.0002759639394 37.4856485423669, 127.0005608969848 37.48595162345273, 127.0006343507362 37.48606911072334, 127.0011841133757 37.48695701912759, 127.0007974634895 37.4899219863172, 127.0002678936836 37.49194669310199, 127.0009744774375 37.49244773025026, 127.0009997079417 37.49246580000456, 127.0015796906339 37.49289414943332, 127.002069127237 37.49325562116127, 127.0021647635872 37.49333376641175, 127.0029066180506 37.49394643415863, 127.0036070982388 37.49482820426832, 127.0096515381639 37.49840029454548, 127.0100941829957 37.49861395027158, 127.0105441139136 37.49876397700206, 127.0124501602212 37.49904733481839, 127.0129072257864 37.49697654656102, 127.0130986885637 37.49618330285249, 127.0133652365298 37.49510653733433, 127.0135548423789 37.49434343001106, 127.0141078301617 37.49401938310255, 127.0141431725442 37.49401520193582, 127.0157623700279 37.49431858110463)))"
342,서울특별시,서초구,서초4동,11650531,31886,15456,16430,"MULTIPOLYGON (((127.0276351080783 37.49796430342111, 127.021276880188 37.49600985787428, 127.0157623700279 37.49431858110463, 127.0141431725442 37.49401520193582, 127.0141078301617 37.49401938310255, 127.0135548423789 37.49434343001106, 127.0133652365298 37.49510653733433, 127.0130986885637 37.49618330285249, 127.0129072257864 37.49697654656102, 127.0124501602212 37.49904733481839, 127.0123823067712 37.49937041702918, 127.0136130795321 37.49962674459574, 127.017850296439 37.50077869956551, 127.0186700025089 37.50283488361819, 127.021074174157 37.50345244918042, 127.0236292552366 37.50424758590078, 127.0244958389723 37.50451810741976, 127.0264857899006 37.50036858341875, 127.0276351080783 37.49796430342111)))"
343,서울특별시,서초구,잠원동,11650540,34953,16607,18346,"MULTIPOLYGON (((127.0194410495604 37.51598724164067, 127.0198568741546 37.51504079994086, 127.0213079938742 37.51116795393767, 127.0203500392138 37.51080519890566, 127.0116219296791 37.50830799626218, 127.0116614693834 37.50915857994743, 127.0093632806059 37.51250877568096, 127.0090643278187 37.51281506267912, 127.0086122293502 37.51327512767916, 127.0085050760182 37.51322285387821, 127.0077042743661 37.5128285557532, 127.0073254440758 37.51257797661376, 127.0067583585078 37.51353104809652, 127.0071791749411 37.51395756770218, 127.0072056825642 37.51398407450505, 127.0074609357806 37.51422829344246, 127.0075955794746 37.51429163426415, 127.0076498242471 37.51433584655462, 127.0076976179501 37.51438111355895, 127.0082358086794 37.51492078889863, 127.008894376183 37.5156456807583, 127.0081896712235 37.51613179252649, 127.008124131789 37.51617686680417, 127.0079122578147 37.51637400306129, 127.0074824304969 37.5167778214499, 127.0044274316538 37.52026117367696, 127.0079721761886 37.52458897654878, 127.0118681148712 37.5278410044609, 127.0146022768249 37.5255087528872, 127.0166135278303 37.52337628485866, 127.0170736024241 37.52288692862943, 127.0172014388461 37.52269704006723, 127.0176092083516 37.5220902917014, 127.0179813714146 37.52130199792263, 127.0182834658048 37.52051905145248, 127.0189154006708 37.51857494289874, 127.0190251971729 37.51823713836514, 127.0194783057337 37.51634195419062, 127.0194410495604 37.51598724164067)))"
344,서울특별시,서초구,반포본동,11650550,12106,5694,6412,"MULTIPOLYGON (((126.9893793179576 37.5127079765066, 126.9902377788 37.51125483533862, 126.992562525296 37.50725381112102, 126.9926190598997 37.50715490477642, 126.9922392433934 37.50633078499143, 126.9920029463799 37.50582613607549, 126.9918521241505 37.50564634274746, 126.9918163250794 37.50539944238094, 126.9918257563143 37.50536342869152, 126.9919048990756 37.50506626287007, 126.9929031266308 37.50289946770017, 126.9939223589209 37.50286099268482, 126.9939459134687 37.50282507086038, 126.9941108315527 37.50256898963633, 126.9941760141837 37.50246776694517, 126.9941896673427 37.50243627790861, 126.9943944184137 37.50195718176936, 126.9944130988826 37.50191332055974, 126.9945065084913 37.50169288779599, 126.994532591673 37.50162917249891, 126.9945396513025 37.50160233054285, 126.9945342662285 37.50156118307539, 126.9945261078678 37.50151270021262, 126.9945213538524 37.50148451245515, 126.9911031753655 37.49951276432516, 126.9901013944356 37.4991783223116, 126.9900618835151 37.49916575809497, 126.9895219876628 37.49901695568833, 126.9889736056945 37.49886698740991, 126.9882332649625 37.49866548378395, 126.9878425016231 37.4986081314519, 126.9869473244186 37.49863173752048, 126.9862000251915 37.4990374714722, 126.981149473721 37.502289584518, 126.9807038874525 37.50274373640521, 126.980445180882 37.5033096232825, 126.9803915951203 37.50359660031162, 126.9803259510256 37.50394928541216, 126.9803159313609 37.50400413123089, 126.9802974007584 37.5048411843747, 126.9801379051013 37.51211780751312, 126.982485579607 37.51350614288573, 126.9849924616736 37.51363306660695, 126.9886237309889 37.51409714647897, 126.9893793179576 37.5127079765066)))"
345,서울특별시,서초구,반포1동,11650560,33139,15937,17202,"MULTIPOLYGON (((127.0244700492047 37.50457187505761, 127.0244958389723 37.50451810741976, 127.0236292552366 37.50424758590078, 127.021074174157 37.50345244918042, 127.0186700025089 37.50283488361819, 127.017850296439 37.50077869956551, 127.0136130795321 37.49962674459574, 127.0123823067712 37.49937041702918, 127.0119351090244 37.50126592899161, 127.011799858385 37.50183885905884, 127.0115827895315 37.50248919275183, 127.0115589948219 37.50255894958983, 127.011518264512 37.50263859909754, 127.0110104190009 37.50362140871188, 127.0108056003645 37.50401715797607, 127.0104618600525 37.50468061122049, 127.0104224579943 37.5047555742547, 127.0100257914596 37.50551018004344, 127.0093698785535 37.50675921718894, 127.0093155919206 37.50686278204982, 127.0091085480843 37.50725780408342, 127.0097516119385 37.50778409373456, 127.0116219296791 37.50830799626218, 127.0203500392138 37.51080519890566, 127.0213748324268 37.51102931760357, 127.0244700492047 37.50457187505761)))"
346,서울특별시,서초구,반포2동,11650570,16381,7809,8572,"MULTIPOLYGON (((127.0009280362828 37.50527051031398, 127.002899853446 37.502752674771, 127.0030634820786 37.50248867242382, 127.003112631497 37.50212261888089, 127.0029518756911 37.50194505116549, 127.0013314314233 37.50127121712497, 126.9948422952407 37.49867255840575, 126.9940040852164 37.4983962751826, 126.9932966411027 37.49824226543159, 126.992868550594 37.49818409358518, 126.9921764783091 37.4981630933836, 126.99070727253 37.4981556417405, 126.9877476109485 37.49823523403149, 126.9878425016231 37.4986081314519, 126.9882332649625 37.49866548378395, 126.9889736056945 37.49886698740991, 126.9895219876628 37.49901695568833, 126.9900618835151 37.49916575809497, 126.9901013944356 37.4991783223116, 126.9911031753655 37.49951276432516, 126.9945213538524 37.50148451245515, 126.9945261078678 37.50151270021262, 126.9945342662285 37.50156118307539, 126.9945396513025 37.50160233054285, 126.994532591673 37.50162917249891, 126.9945065084913 37.50169288779599, 126.9944130988826 37.50191332055974, 126.9943944184137 37.50195718176936, 126.9941896673427 37.50243627790861, 126.9941760141837 37.50246776694517, 126.9941108315527 37.50256898963633, 126.9939459134687 37.50282507086038, 126.9939223589209 37.50286099268482, 126.9929031266308 37.50289946770017, 126.9919048990756 37.50506626287007, 126.9918257563143 37.50536342869152, 126.9918163250794 37.50539944238094, 126.9918521241505 37.50564634274746, 126.9920029463799 37.50582613607549, 126.9922392433934 37.50633078499143, 126.9926190598997 37.50715490477642, 126.992562525296 37.50725381112102, 126.9902377788 37.51125483533862, 126.9893793179576 37.5127079765066, 126.9959414896796 37.51574214068492, 126.99839793674 37.51062192426717, 126.9995630845059 37.5082481287189, 127.0002767811988 37.50673687121029, 127.0005274137185 37.50619403457709, 127.0009280362828 37.50527051031398)))"
347,서울특별시,서초구,반포3동,11650580,20324,9608,10716,"MULTIPOLYGON (((127.0116219296791 37.50830799626218, 127.0097516119385 37.50778409373456, 127.0009280362828 37.50527051031398, 127.0005274137185 37.50619403457709, 127.0002767811988 37.50673687121029, 126.9995630845059 37.5082481287189, 126.99839793674 37.51062192426717, 126.9959414896796 37.51574214068492, 127.0003873205798 37.51794907783463, 127.0044274316538 37.52026117367696, 127.0074824304969 37.5167778214499, 127.0079122578147 37.51637400306129, 127.008124131789 37.51617686680417, 127.0081896712235 37.51613179252649, 127.008894376183 37.5156456807583, 127.0082358086794 37.51492078889863, 127.0076976179501 37.51438111355895, 127.0076498242471 37.51433584655462, 127.0075955794746 37.51429163426415, 127.0074609357806 37.51422829344246, 127.0072056825642 37.51398407450505, 127.0071791749411 37.51395756770218, 127.0067583585078 37.51353104809652, 127.0073254440758 37.51257797661376, 127.0077042743661 37.5128285557532, 127.0085050760182 37.51322285387821, 127.0086122293502 37.51327512767916, 127.0090643278187 37.51281506267912, 127.0093632806059 37.51250877568096, 127.0116614693834 37.50915857994743, 127.0116219296791 37.50830799626218)))"
348,서울특별시,서초구,반포4동,11650581,20270,9593,10677,"MULTIPOLYGON (((127.0123823067712 37.49937041702918, 127.0124501602212 37.49904733481839, 127.0105441139136 37.49876397700206, 127.0100941829957 37.49861395027158, 127.0096515381639 37.49840029454548, 127.0036070982388 37.49482820426832, 127.0029066180506 37.49394643415863, 127.0021647635872 37.49333376641175, 127.002069127237 37.49325562116127, 127.0015796906339 37.49289414943332, 127.0009997079417 37.49246580000456, 127.0009744774375 37.49244773025026, 127.0002678936836 37.49194669310199, 126.9972451089058 37.49367910834076, 126.9954603992668 37.49401965026918, 126.9954320323087 37.49434852493737, 126.9953309923532 37.49475821139665, 126.9952657299382 37.49484395821844, 126.9952275631435 37.49489409995134, 126.9949071580252 37.4953260386313, 126.9949608112633 37.49549393146088, 126.9950484441072 37.49576877864912, 126.995005827721 37.49581265486935, 126.9949601583721 37.49585966376186, 126.994835455052 37.49598655737416, 126.9948490505577 37.49605493935702, 126.9945949701079 37.49612174921595, 126.9945252394708 37.49613497124251, 126.9944883107035 37.49611455970867, 126.9942366229269 37.49611469476002, 126.9941705710533 37.49612340300246, 126.9941303970519 37.49612877432956, 126.9937795404797 37.49617344795433, 126.9936125978574 37.49601223214046, 126.9929495950592 37.49634115383802, 126.9929433908135 37.49663182687323, 126.9927622620265 37.49691159603976, 126.9922427176051 37.49704682116243, 126.9918779501897 37.49714102203196, 126.991839716689 37.49714874445392, 126.9916089992532 37.49718898889445, 126.9912514514899 37.49725099535137, 126.9909173610412 37.49751207653922, 126.9907076937922 37.49788072946959, 126.9907073227013 37.49810028057018, 126.99070727253 37.4981556417405, 126.9921764783091 37.4981630933836, 126.992868550594 37.49818409358518, 126.9932966411027 37.49824226543159, 126.9940040852164 37.4983962751826, 126.9948422952407 37.49867255840575, 127.0013314314233 37.50127121712497, 127.0029518756911 37.50194505116549, 127.003112631497 37.50212261888089, 127.0030634820786 37.50248867242382, 127.002899853446 37.502752674771, 127.0009280362828 37.50527051031398, 127.0097516119385 37.50778409373456, 127.0091085480843 37.50725780408342, 127.0093155919206 37.50686278204982, 127.0093698785535 37.50675921718894, 127.0100257914596 37.50551018004344, 127.0104224579943 37.5047555742547, 127.0104618600525 37.50468061122049, 127.0108056003645 37.50401715797607, 127.0110104190009 37.50362140871188, 127.011518264512 37.50263859909754, 127.0115589948219 37.50255894958983, 127.0115827895315 37.50248919275183, 127.011799858385 37.50183885905884, 127.0119351090244 37.50126592899161, 127.0123823067712 37.49937041702918)))"
349,서울특별시,서초구,방배본동,11650590,21471,9991,11480,"MULTIPOLYGON (((126.9877476109485 37.49823523403149, 126.99070727253 37.4981556417405, 126.9907073227013 37.49810028057018, 126.9907076937922 37.49788072946959, 126.9909173610412 37.49751207653922, 126.9912514514899 37.49725099535137, 126.9916089992532 37.49718898889445, 126.991839716689 37.49714874445392, 126.9918779501897 37.49714102203196, 126.9922427176051 37.49704682116243, 126.9927622620265 37.49691159603976, 126.9929433908135 37.49663182687323, 126.9929495950592 37.49634115383802, 126.9936125978574 37.49601223214046, 126.9937795404797 37.49617344795433, 126.9941303970519 37.49612877432956, 126.9941705710533 37.49612340300246, 126.9942366229269 37.49611469476002, 126.9944883107035 37.49611455970867, 126.9945252394708 37.49613497124251, 126.9945949701079 37.49612174921595, 126.9948490505577 37.49605493935702, 126.994835455052 37.49598655737416, 126.9949601583721 37.49585966376186, 126.995005827721 37.49581265486935, 126.9950484441072 37.49576877864912, 126.9949608112633 37.49549393146088, 126.9949071580252 37.4953260386313, 126.9952275631435 37.49489409995134, 126.9952657299382 37.49484395821844, 126.9953309923532 37.49475821139665, 126.9954320323087 37.49434852493737, 126.9954603992668 37.49401965026918, 126.9922868630156 37.49355481148457, 126.9904384337739 37.49285036173598, 126.9891058903556 37.49231919302407, 126.9874376430555 37.49165397514771, 126.9864339797515 37.49125362251227, 126.9858850612963 37.49103430506144, 126.9855018535901 37.49088285175143, 126.9850645639456 37.49088313414153, 126.9826515615954 37.49089174580023, 126.9827384278102 37.49398040475325, 126.982744573428 37.49419698381431, 126.9827472630333 37.49428595961953, 126.982764971979 37.49484131868661, 126.9827713872636 37.49503964549882, 126.982778132061 37.49524022714131, 126.9829001998747 37.49635281069553, 126.9829175161619 37.49640584125234, 126.9829606464679 37.49650180829037, 126.9830400895135 37.49667678498616, 126.983077757187 37.49675945107592, 126.9832448672641 37.49712610631634, 126.9833604408782 37.49732634363158, 126.9834398044866 37.49746384124858, 126.9834880294342 37.49754630098268, 126.9847664869855 37.49927787962328, 126.9862491125148 37.498576875017, 126.9877476109485 37.49823523403149)))"
350,서울특별시,서초구,방배1동,11650600,17559,8245,9314,"MULTIPOLYGON (((127.0021516263079 37.48229539968448, 127.0006266758572 37.48191155548803, 126.9977227529196 37.48132023643123, 126.9962694886907 37.48102661278268, 126.9952304453024 37.48070108215464, 126.9936378461754 37.48018051362615, 126.9896295148121 37.48644228226964, 126.990365254715 37.4866765001369, 126.9905648831089 37.48673932144321, 126.9916293667712 37.48706248313908, 126.9990757181514 37.48932092725489, 127.0007974634895 37.4899219863172, 127.0011841133757 37.48695701912759, 127.0006343507362 37.48606911072334, 127.0005608969848 37.48595162345273, 127.0002759639394 37.4856485423669, 127.0005852681726 37.48515963391874, 127.000638587277 37.48500777732822, 127.000828858531 37.48446100515567, 127.0008289855104 37.48433481527865, 127.000828674276 37.48421498714998, 127.0008285911282 37.48418158239238, 127.0008286302641 37.48365649248711, 127.0018854649892 37.48279682233944, 127.0021516263079 37.48229539968448)))"
351,서울특별시,서초구,방배2동,11650610,21135,9972,11163,"MULTIPOLYGON (((126.9936378461754 37.48018051362615, 126.9909201044365 37.47929449365871, 126.9902902415615 37.47908897199185, 126.9899970880971 37.4789547562881, 126.9873186188529 37.47762041690125, 126.9869687277518 37.47741271192832, 126.986598889245 37.47712379768529, 126.9860636754758 37.4760049102566, 126.9860229617239 37.47585938872344, 126.9856759756303 37.47461062063621, 126.9859459482927 37.47277172973421, 126.9868070378526 37.47118247862528, 126.9890752151759 37.47066163120745, 126.9928742160481 37.46952538017371, 126.993723829475 37.46920565978394, 126.9947477453672 37.46881907650032, 126.9962750988206 37.46671749087118, 126.996461082408 37.46480405943685, 126.9972194998225 37.46393659915106, 126.9971615676436 37.46352485335355, 126.9969585194574 37.46250094192894, 126.9968320118161 37.46218492617582, 126.9917619810249 37.45967208651574, 126.9886204638784 37.45813532321736, 126.9876394888408 37.45940190298298, 126.9874672782277 37.46040934010766, 126.9876392329454 37.4613037783615, 126.9879211815878 37.46224129135372, 126.9880215242642 37.46276226323842, 126.9882344549443 37.46387298857078, 126.9881638302608 37.4655244296988, 126.9878072688463 37.46640509320054, 126.9875915775051 37.46693711919738, 126.987389082213 37.4671909262415, 126.987131088415 37.46751421602703, 126.9868629934932 37.46784996956239, 126.9867109733556 37.46796983313727, 126.9866654940081 37.46800569005608, 126.985429038496 37.46897603644689, 126.9845276239683 37.46974495320689, 126.9837809856857 37.47079861232137, 126.9832349577435 37.47157026974844, 126.9826512774708 37.47257386018693, 126.9825533140157 37.47274324767584, 126.9825375417371 37.47277053491663, 126.9819492496233 37.47442317146226, 126.981860324741 37.474698129272, 126.981766439354 37.47583403693234, 126.9817228223633 37.47636480563454, 126.9816097529059 37.47715329934684, 126.9818078281263 37.48058889244171, 126.9820701724793 37.48480590653122, 126.9820829814068 37.48538655525137, 126.9896295148121 37.48644228226964, 126.9936378461754 37.48018051362615)))"
352,서울특별시,서초구,방배3동,11650620,22489,10841,11648,"MULTIPOLYGON (((127.0103100761861 37.47226020215308, 127.0096794141727 37.47160303825181, 127.00741939265 37.47053115757788, 127.0056678960574 37.46996830645993, 127.0044686201853 37.46928486824978, 127.0041727235942 37.46883421214651, 127.0038244915172 37.46815898186131, 127.0034219370058 37.46725934879104, 126.9997473438548 37.46715930627222, 126.9962750988206 37.46671749087118, 126.9947477453672 37.46881907650032, 126.993723829475 37.46920565978394, 126.9928742160481 37.46952538017371, 126.9890752151759 37.47066163120745, 126.9868070378526 37.47118247862528, 126.9859459482927 37.47277172973421, 126.9856759756303 37.47461062063621, 126.9860229617239 37.47585938872344, 126.9860636754758 37.4760049102566, 126.986598889245 37.47712379768529, 126.9869687277518 37.47741271192832, 126.9873186188529 37.47762041690125, 126.9899970880971 37.4789547562881, 126.9902902415615 37.47908897199185, 126.9909201044365 37.47929449365871, 126.9936378461754 37.48018051362615, 126.9952304453024 37.48070108215464, 126.9962694886907 37.48102661278268, 126.9977227529196 37.48132023643123, 127.0006266758572 37.48191155548803, 127.0021516263079 37.48229539968448, 127.0029638997371 37.48127421508983, 127.002670308565 37.48085318893781, 127.0029488527445 37.48031692473237, 127.0031681347225 37.479974203212, 127.0033074208222 37.47975733552192, 127.0035809137252 37.47934047879561, 127.0038415571734 37.47894384806325, 127.0039572076008 37.47877048815107, 127.0041017912628 37.47855397521132, 127.005416022872 37.47901579789404, 127.0066406136884 37.47821530986733, 127.009089387811 37.47485330672691, 127.0103100761861 37.47226020215308)))"
353,서울특별시,서초구,방배4동,11650621,24278,11174,13104,"MULTIPOLYGON (((127.0002678936836 37.49194669310199, 127.0007974634895 37.4899219863172, 126.9990757181514 37.48932092725489, 126.9916293667712 37.48706248313908, 126.9905648831089 37.48673932144321, 126.990365254715 37.4866765001369, 126.9896295148121 37.48644228226964, 126.9820829814068 37.48538655525137, 126.9826515615954 37.49089174580023, 126.9850645639456 37.49088313414153, 126.9855018535901 37.49088285175143, 126.9858850612963 37.49103430506144, 126.9864339797515 37.49125362251227, 126.9874376430555 37.49165397514771, 126.9891058903556 37.49231919302407, 126.9904384337739 37.49285036173598, 126.9922868630156 37.49355481148457, 126.9954603992668 37.49401965026918, 126.9972451089058 37.49367910834076, 127.0002678936836 37.49194669310199)))"
354,서울특별시,서초구,양재1동,11650651,46022,22005,24017,"MULTIPOLYGON (((127.0439421898421 37.47971047664745, 127.0414131117334 37.47667098307046, 127.041375895299 37.47663140400312, 127.0403076720073 37.475500549439, 127.0393218620642 37.47471197000633, 127.0392658010379 37.47468977168609, 127.0376191824072 37.47406027333997, 127.0375296295 37.47402612175539, 127.0365779464263 37.47372606999092, 127.0356742484702 37.47344197299376, 127.0351894693287 37.47330355556092, 127.034689948055 37.47316093181774, 127.0337804627048 37.47290045833535, 127.0330669568451 37.47239719517074, 127.032745962886 37.47217077479092, 127.0308042612818 37.47036936793671, 127.0289724574391 37.46785060762435, 127.0298611186533 37.4654453005473, 127.0300760994277 37.46418424593989, 127.0299930678293 37.463899985093, 127.0298623627197 37.46345355304681, 127.0261049792199 37.45851014202381, 127.0258036140094 37.45836109396738, 127.0246921324841 37.45781147244004, 127.023376794921 37.45728450982559, 127.022616921136 37.45698061213877, 127.0218450316237 37.45667891436445, 127.0215968972699 37.45658214009782, 127.0205338733649 37.4561677109179, 127.0178591729515 37.4556081230244, 127.0161710632097 37.4553691223831, 127.011060328399 37.45538864973786, 127.0051557557203 37.46306059579489, 127.0041712413654 37.46477807293835, 127.0034219370058 37.46725934879104, 127.0038244915172 37.46815898186131, 127.0041727235942 37.46883421214651, 127.0044686201853 37.46928486824978, 127.0056678960574 37.46996830645993, 127.00741939265 37.47053115757788, 127.0096794141727 37.47160303825181, 127.0103100761861 37.47226020215308, 127.0135944039 37.47317625041693, 127.014995242126 37.47420072377637, 127.0150224601761 37.47423108070215, 127.0155060934365 37.47475585480396, 127.0168398842667 37.47596688807879, 127.0180706829848 37.47660399466169, 127.0198319417723 37.47687481366636, 127.0202751209363 37.47686760023948, 127.0208367871925 37.47711472529081, 127.0217793608467 37.47752943886118, 127.0240408691743 37.47935976301049, 127.0241197158027 37.48033310947108, 127.024439701192 37.48053797936051, 127.0245252976012 37.48059276969647, 127.0255129091646 37.48079840702298, 127.0270147928412 37.48050810722698, 127.0279117817392 37.48085646547389, 127.02865560373 37.48105660802032, 127.0294079824593 37.48045569481998, 127.0304119726419 37.4802005433929, 127.0325226960076 37.48100774987677, 127.0339279234372 37.48221195113485, 127.0341323200084 37.48244318042338, 127.0343645164419 37.48277718579683, 127.0343629208344 37.48280647375728, 127.0343590003938 37.48286955361115, 127.0336295469175 37.48401346955486, 127.0339679429088 37.48479724859385, 127.0413458460977 37.48557052780573, 127.0415366307098 37.48508954292947, 127.0439421898421 37.47971047664745)))"
355,서울특별시,서초구,양재2동,11650652,23250,11703,11547,"MULTIPOLYGON (((127.0495805879957 37.47048749255598, 127.0478839980551 37.4692101883366, 127.0472672934671 37.46874587804322, 127.0467804186005 37.4683864035543, 127.0448536270596 37.46696420838595, 127.0430974002771 37.46566847986032, 127.0430327002142 37.46562074760246, 127.0440128568201 37.46471336075196, 127.045358228359 37.46346885649002, 127.0455590167846 37.46127073904223, 127.0455189962359 37.46119465413356, 127.0455288622704 37.46084991989481, 127.0458199689024 37.45934012543758, 127.0459064204226 37.45917433600939, 127.0459307987218 37.45912760374508, 127.0460492936157 37.45893201198713, 127.046368787297 37.45845326167461, 127.0476782037944 37.45752874737241, 127.0494801191503 37.45584574954564, 127.0497785496242 37.45539489769266, 127.0506994507804 37.45384016538389, 127.0506938185395 37.45381397730321, 127.0506870750585 37.45378265622225, 127.0506186741611 37.45352325328918, 127.0504984439555 37.45306760596388, 127.0506684107062 37.45259908198028, 127.0508670109665 37.45205162568251, 127.0512937065808 37.45159914692898, 127.051904566195 37.45095248045099, 127.054160237166 37.44878871646081, 127.0543760108499 37.44858588431159, 127.0544551165343 37.44851153130832, 127.054506271388 37.44846440235526, 127.056137440353 37.44697314279051, 127.0586701148663 37.44331969294328, 127.0599324052266 37.44120393018998, 127.0605115984222 37.44089168964353, 127.0614594136947 37.44056625378914, 127.0633587923114 37.43821507902193, 127.0635386143109 37.43790815091631, 127.0639093401627 37.43684477671647, 127.0639248608203 37.43648428618766, 127.0639567022714 37.43574415390437, 127.0637667472909 37.43535783806232, 127.0637402368169 37.43530389239573, 127.0637119421064 37.43523991690622, 127.0633685847376 37.43446316462068, 127.063280220829 37.43417402126236, 127.0631834716638 37.4338574361805, 127.0631086092854 37.43361040949581, 127.0630317580204 37.43164063183662, 127.0631560284241 37.42970655656821, 127.0618837223904 37.4298336417131, 127.0579699857536 37.43013371714853, 127.0578885105373 37.43013537292797, 127.0545930552574 37.42941429917556, 127.0508934883694 37.42965493838712, 127.0498652419964 37.43031128084812, 127.0489638023095 37.43055234130117, 127.0474670477172 37.4308710922291, 127.0472637960927 37.43189789707763, 127.0472428787025 37.4319693640782, 127.0471949528846 37.43206776690297, 127.0470937096104 37.4322217394779, 127.0469864497967 37.43231822478915, 127.0469588755912 37.43234355125199, 127.0468307479826 37.43248325462573, 127.0467361206445 37.43259330957757, 127.0466534061856 37.43272031081924, 127.0466061870489 37.4328070361537, 127.0465524089849 37.43292778373651, 127.0464935718975 37.43310165302022, 127.0464703879518 37.43319733457307, 127.0464283945166 37.43336618021048, 127.0464103810288 37.43342357338733, 127.0463909455291 37.43348434123901, 127.0463431864879 37.43355401407997, 127.0462820921493 37.43361011517378, 127.0461928044869 37.43366158312411, 127.0461603661233 37.43367840883256, 127.046041226942 37.4337207348349, 127.045591767057 37.43386322692079, 127.0454286217616 37.43390481976549, 127.0453915231438 37.43391428568658, 127.0453542886042 37.43392940265866, 127.0452293498912 37.43398013784113, 127.0451230768649 37.43403191820169, 127.045045828349 37.43406956854857, 127.0449281074458 37.43414347835315, 127.0448592871985 37.43419278868797, 127.0447751326742 37.43425999520215, 127.0447226092398 37.43430320735897, 127.0446647230966 37.43435653923759, 127.0445963575308 37.43444641278168, 127.0445750979669 37.43448146894694, 127.0445428216892 37.43453634342735, 127.0444964200262 37.43464817776899, 127.0444732838526 37.43470395546902, 127.0444535183073 37.4347713062134, 127.0444386501086 37.43482325340286, 127.0443519064008 37.43503023394708, 127.0442955279846 37.43512466035762, 127.0442178691466 37.43523139850892, 127.0440998517391 37.43535375490936, 127.0440678684005 37.43538630617319, 127.0437105081339 37.43571505449773, 127.0410599762134 37.43811482660868, 127.0409748398578 37.4381730849633, 127.0408678998193 37.43821435790353, 127.0405242913342 37.43833961086864, 127.0400071409917 37.43848367516484, 127.0399060287682 37.43849792885752, 127.039811338268 37.43850094036078, 127.0397061344525 37.43848926361022, 127.0395818955828 37.4384718790674, 127.0390155042419 37.43843474340854, 127.0374814351897 37.43847494553897, 127.0373874982318 37.43848205927477, 127.0373117942054 37.43848780212126, 127.037168155831 37.43852216868138, 127.0358642670874 37.43915589962556, 127.0358390351838 37.43918532485695, 127.0357994285703 37.43927170156024, 127.0354727123932 37.4404376842134, 127.0354602382785 37.44048792250658, 127.0354484320744 37.44053617590675, 127.0354199700252 37.44074056188904, 127.0354104048813 37.44082839865031, 127.0353930030805 37.44098833206388, 127.0353928889123 37.4411201566674, 127.035413112466 37.44117267053313, 127.0365157329511 37.44189523368574, 127.0366015813093 37.44195190578608, 127.0366540012722 37.44198760265196, 127.036711312674 37.44203120563584, 127.0367597489721 37.44208322413047, 127.0368130489641 37.44214765547206, 127.0375692161338 37.44345410222213, 127.0380006623269 37.44422882932755, 127.0380864578195 37.44441056486724, 127.0381519036105 37.44456855992743, 127.0381755730544 37.44462611459069, 127.038203377956 37.44470058604608, 127.0382124050997 37.44472540892068, 127.038322780697 37.44516074988561, 127.0383682702039 37.44546288562499, 127.0383699000107 37.44553967766858, 127.0383586354317 37.4456510084154, 127.0378874570344 37.44907886853612, 127.0378765172891 37.44913516118191, 127.0358347365538 37.45754591860271, 127.0356241370781 37.45751318290408, 127.0354757692509 37.45752466908148, 127.0354084457111 37.45753171179876, 127.0351622207153 37.45761876458229, 127.0349246438392 37.45786795873334, 127.0337848146151 37.46003049254608, 127.0334294628999 37.46107522675779, 127.0340056683363 37.46235539119716, 127.0340698897758 37.46247650840691, 127.034366127015 37.46303510602716, 127.034734914894 37.46384783438857, 127.0345754857087 37.4640364038505, 127.0343681470941 37.46418997002175, 127.034067827655 37.46441074722816, 127.0331424141315 37.4650234025453, 127.0327211731351 37.46525271212239, 127.0312689402855 37.46577535727362, 127.0298611186533 37.4654453005473, 127.0289724574391 37.46785060762435, 127.0308042612818 37.47036936793671, 127.032745962886 37.47217077479092, 127.0330669568451 37.47239719517074, 127.0337804627048 37.47290045833535, 127.034689948055 37.47316093181774, 127.0351894693287 37.47330355556092, 127.0356742484702 37.47344197299376, 127.0365779464263 37.47372606999092, 127.0375296295 37.47402612175539, 127.0376191824072 37.47406027333997, 127.0392658010379 37.47468977168609, 127.0393218620642 37.47471197000633, 127.0403076720073 37.475500549439, 127.041375895299 37.47663140400312, 127.0414131117334 37.47667098307046, 127.0439421898421 37.47971047664745, 127.0445748748024 37.47819412137235, 127.044688649452 37.477966965815, 127.0450299533538 37.47728662504824, 127.0491520490357 37.47331891359557, 127.0507127069182 37.47182244814768, 127.0510574550327 37.4714913535671, 127.0503936734613 37.47103930158703, 127.0495805879957 37.47048749255598)))"
356,서울특별시,서초구,내곡동,11650660,18545,9030,9515,"MULTIPOLYGON (((127.0851618267097 37.47527333765135, 127.0850691436286 37.47494136694652, 127.0844915817287 37.47287221121245, 127.0849022471739 37.47211121725942, 127.0851985860219 37.47156208288457, 127.0862116656786 37.47036347997633, 127.0887645194545 37.46807387004427, 127.0933601800066 37.46439642674009, 127.094035920871 37.46398750180195, 127.0950165546593 37.46365736109222, 127.0959959704971 37.46249907760831, 127.0960864720589 37.46222897701581, 127.0962571265207 37.46164254518388, 127.0963176312864 37.46143202137049, 127.0958665979855 37.4610620821808, 127.0954064484522 37.46028983905316, 127.0946273203112 37.45878188620678, 127.0949458259655 37.45842468491534, 127.095121769067 37.45830022314794, 127.0942833307608 37.45652390759057, 127.0930693048986 37.4548184023928, 127.0921385476287 37.45362282864219, 127.0913801221002 37.45330728994293, 127.0909600520451 37.45297796424748, 127.0908230477021 37.45283100779609, 127.0896872089749 37.45119785716329, 127.0883242428717 37.44863730582032, 127.0881930257725 37.44636918112464, 127.0879896236933 37.44506151987159, 127.0856503626127 37.44502742776832, 127.0855464723418 37.44498779086615, 127.0854268447253 37.44494214062431, 127.0841270489032 37.44399677044361, 127.0839422071389 37.44381809953551, 127.0832299809151 37.44254691324632, 127.0825739735455 37.44146295515009, 127.0823111931626 37.44119950298414, 127.0815774846977 37.44100424016319, 127.081286361451 37.44098135099464, 127.0812173098025 37.44097592258007, 127.0810012031629 37.44095938272307, 127.0773366063422 37.44180601679174, 127.0770783960012 37.44197291906029, 127.0770401941381 37.44199762409225, 127.0767381980014 37.44217681681872, 127.0763299660082 37.4422745047957, 127.0747577953676 37.44241871142911, 127.0724238198897 37.44235311818686, 127.0723709132925 37.44232559637515, 127.0721502823395 37.44220789938903, 127.0719200947674 37.44208510168513, 127.071787128396 37.44194240204119, 127.0717620835 37.44191552261759, 127.071680849827 37.4418277864667, 127.0716511331528 37.44179568919055, 127.071662202381 37.44170213115485, 127.0716786032061 37.44156368623558, 127.0719686780533 37.44000536582299, 127.073377726773 37.4393400693707, 127.0726307647119 37.43638989243632, 127.0714301467083 37.43520137071211, 127.0709201268411 37.43185093021745, 127.0704563100031 37.43006340527567, 127.0693479734066 37.43042442768967, 127.0681601579917 37.43057635676532, 127.0667464656239 37.43013098951591, 127.0660141650481 37.42959424205166, 127.0657829104797 37.42926908866148, 127.0657016382104 37.42915480275973, 127.0656944302002 37.4291168916677, 127.0656742590993 37.42901070369192, 127.0655319887848 37.42902297492705, 127.0653787818103 37.42903643795377, 127.064668613478 37.42914508991112, 127.0642856878288 37.42920367430062, 127.0631560284241 37.42970655656821, 127.0630317580204 37.43164063183662, 127.0631086092854 37.43361040949581, 127.0631834716638 37.4338574361805, 127.063280220829 37.43417402126236, 127.0633685847376 37.43446316462068, 127.0637119421064 37.43523991690622, 127.0637402368169 37.43530389239573, 127.0637667472909 37.43535783806232, 127.0639567022714 37.43574415390437, 127.0639248608203 37.43648428618766, 127.0639093401627 37.43684477671647, 127.0635386143109 37.43790815091631, 127.0633587923114 37.43821507902193, 127.0614594136947 37.44056625378914, 127.0605115984222 37.44089168964353, 127.0599324052266 37.44120393018998, 127.0586701148663 37.44331969294328, 127.056137440353 37.44697314279051, 127.054506271388 37.44846440235526, 127.0544551165343 37.44851153130832, 127.0543760108499 37.44858588431159, 127.054160237166 37.44878871646081, 127.051904566195 37.45095248045099, 127.0512937065808 37.45159914692898, 127.0508670109665 37.45205162568251, 127.0506684107062 37.45259908198028, 127.0504984439555 37.45306760596388, 127.0506186741611 37.45352325328918, 127.0506870750585 37.45378265622225, 127.0506938185395 37.45381397730321, 127.0506994507804 37.45384016538389, 127.0497785496242 37.45539489769266, 127.0494801191503 37.45584574954564, 127.0476782037944 37.45752874737241, 127.046368787297 37.45845326167461, 127.0460492936157 37.45893201198713, 127.0459307987218 37.45912760374508, 127.0459064204226 37.45917433600939, 127.0458199689024 37.45934012543758, 127.0455288622704 37.46084991989481, 127.0455189962359 37.46119465413356, 127.0455590167846 37.46127073904223, 127.045358228359 37.46346885649002, 127.0440128568201 37.46471336075196, 127.0430327002142 37.46562074760246, 127.0430974002771 37.46566847986032, 127.0448536270596 37.46696420838595, 127.0467804186005 37.4683864035543, 127.0472672934671 37.46874587804322, 127.0478839980551 37.4692101883366, 127.0495805879957 37.47048749255598, 127.0500699309385 37.47009952506586, 127.053810698328 37.46873124228762, 127.0541610814936 37.46863117935794, 127.0545271867516 37.46852663178099, 127.0562066558302 37.46838535290122, 127.0567485528101 37.46842006132609, 127.0616116613502 37.46895874049018, 127.0621631882913 37.46964694905392, 127.0622804215945 37.47022579791248, 127.0625318878364 37.47284246894814, 127.0692436338979 37.47388572469986, 127.0697580502096 37.47477656909389, 127.0708137529753 37.47483449027618, 127.0726531777392 37.47479946922746, 127.0739132085454 37.47285819987911, 127.0759435921166 37.47379503591845, 127.076151731174 37.47398732260724, 127.0771623877226 37.47500946525027, 127.0783352301617 37.47485706345417, 127.079040124138 37.47482690241954, 127.0792479214745 37.47482989596271, 127.0803510094767 37.47488564816519, 127.0810230473899 37.4751697093587, 127.0816325535757 37.47526200545619, 127.0821884554423 37.47533157477234, 127.0830017416782 37.47538740294046, 127.0838722652993 37.47544568051607, 127.0840467565666 37.47543659623245, 127.0851618267097 37.47527333765135)))"
357,서울특별시,강남구,신사동,11680510,17623,8207,9416,"MULTIPOLYGON (((127.0280781532315 37.519584003369, 127.0272059232989 37.51926729481519, 127.0252608014645 37.51855642054488, 127.0211687299595 37.51681920093201, 127.0194410495604 37.51598724164067, 127.0194783057337 37.51634195419062, 127.0190251971729 37.51823713836514, 127.0189154006708 37.51857494289874, 127.0182834658048 37.52051905145248, 127.0179813714146 37.52130199792263, 127.0176092083516 37.5220902917014, 127.0172014388461 37.52269704006723, 127.0170736024241 37.52288692862943, 127.0166135278303 37.52337628485866, 127.0146022768249 37.5255087528872, 127.0118681148712 37.5278410044609, 127.0126091764842 37.52831276912609, 127.0154570894157 37.53070180857035, 127.0163745366173 37.53147171975786, 127.0170382269451 37.53202891694836, 127.018222147936 37.53302283940944, 127.0195125720225 37.53410521396481, 127.0200593026991 37.53456262055563, 127.020181900875 37.53464200517251, 127.0209244123452 37.53511935680613, 127.0215649184989 37.5355309658779, 127.0242429860664 37.53166029070537, 127.0243550673817 37.53149849850466, 127.0244236709124 37.5313997881221, 127.0252430503104 37.53023679609947, 127.0256950652302 37.52979018872576, 127.0261755354305 37.52931552642519, 127.0265915908875 37.52897148956885, 127.0268695481673 37.52874144214648, 127.0274071192062 37.52829629747193, 127.0279989309038 37.52777362526999, 127.0283124841652 37.52729378004371, 127.02834411019 37.52721391113644, 127.028564254372 37.52730820109505, 127.0286215941498 37.52661275908329, 127.0285909585933 37.52593768707884, 127.0285558436765 37.52555133351237, 127.028373454163 37.52457531138199, 127.0282460366683 37.52256928739047, 127.0281745300172 37.5213442851718, 127.0281624092873 37.52113467160709, 127.0280781532315 37.519584003369)))"
358,서울특별시,강남구,논현1동,11680521,23810,11081,12729,"MULTIPOLYGON (((127.0338873528466 37.5073920313264, 127.0244700492047 37.50457187505761, 127.0213748324268 37.51102931760357, 127.0203500392138 37.51080519890566, 127.0213079938742 37.51116795393767, 127.0198568741546 37.51504079994086, 127.0194410495604 37.51598724164067, 127.0211687299595 37.51681920093201, 127.0252608014645 37.51855642054488, 127.0272059232989 37.51926729481519, 127.0280781532315 37.519584003369, 127.0282726376278 37.51946311620791, 127.0296907750228 37.51641540934033, 127.0302291619695 37.51525818231015, 127.0305503267343 37.51456766902792, 127.0306858848334 37.51427535697993, 127.0307694204151 37.51409521203704, 127.0304622656413 37.51390153284492, 127.0308520067968 37.51391786737886, 127.030957399539 37.51369163440297, 127.0311245443215 37.51333283696373, 127.0316824084912 37.51213362348466, 127.0338873528466 37.5073920313264)))"
359,서울특별시,강남구,논현2동,11680531,22002,10245,11757,"MULTIPOLYGON (((127.0391780751905 37.52290539552294, 127.0412417112372 37.51730376330539, 127.0402705174165 37.51692858044005, 127.0413131850367 37.51710230739545, 127.0430540066438 37.51237232429997, 127.0437657993879 37.51026326732595, 127.0338873528466 37.5073920313264, 127.0316824084912 37.51213362348466, 127.0311245443215 37.51333283696373, 127.030957399539 37.51369163440297, 127.0308520067968 37.51391786737886, 127.0304622656413 37.51390153284492, 127.0307694204151 37.51409521203704, 127.0306858848334 37.51427535697993, 127.0305503267343 37.51456766902792, 127.0302291619695 37.51525818231015, 127.0296907750228 37.51641540934033, 127.0282726376278 37.51946311620791, 127.0280781532315 37.519584003369, 127.0305175885806 37.52035875098888, 127.0327898173994 37.52107983229733, 127.033865598605 37.52142096466066, 127.0374086055561 37.52253567535443, 127.0382648949681 37.52280492602354, 127.0388367071588 37.52298405117769, 127.0390613257567 37.52293229787755, 127.0391780751905 37.52290539552294)))"
360,서울특별시,강남구,삼성1동,11680580,14928,7481,7447,"MULTIPOLYGON (((127.0669618590224 37.52508139275426, 127.0664966552108 37.52092972214779, 127.0671582574394 37.51998043480461, 127.0683814814147 37.51230647185658, 127.0684409616945 37.51143462515148, 127.0684631425072 37.51028434761371, 127.0673659706454 37.51008540634464, 127.0665493816083 37.5099370775886, 127.0604958370752 37.50801960246717, 127.05669182524 37.50685502947763, 127.0561775624808 37.50777450306385, 127.0552952319378 37.50935330178475, 127.0546462092782 37.51051586179897, 127.0546248863461 37.51055487329568, 127.0546068807655 37.51058782214457, 127.0528078603594 37.51392250179745, 127.052688960139 37.51414381252372, 127.0524100612393 37.51466379457713, 127.0517033652953 37.51599399722007, 127.0509816825171 37.51746046760847, 127.0502725560441 37.51885264518489, 127.0511273482708 37.51900121449547, 127.0562207746221 37.51988801787054, 127.0569954100586 37.52004410246758, 127.0573136325606 37.52010844377664, 127.057769625831 37.5202622559428, 127.0580809051947 37.52036820375027, 127.058307490992 37.52044566664458, 127.0584000527219 37.52047759810067, 127.0588290926506 37.52062788745408, 127.0603212197725 37.52115060492256, 127.0605638979865 37.52123597240857, 127.0606249009166 37.52126633351427, 127.0615485299137 37.52172640214491, 127.0619436219763 37.52213798538031, 127.0652649061698 37.52560351988906, 127.0669618590224 37.52508139275426)))"
361,서울특별시,강남구,삼성2동,11680590,30362,14490,15872,"MULTIPOLYGON (((127.05669182524 37.50685502947763, 127.0490428489952 37.50439748322853, 127.0471782349514 37.50397402969755, 127.0489297064122 37.50463080869956, 127.048675262996 37.50514025817236, 127.048257280533 37.50597575837797, 127.0481413075366 37.50620745245322, 127.0477695540725 37.50659131903346, 127.0472785999956 37.50690833536937, 127.0469889651345 37.50709313008724, 127.0468746925831 37.50716367374586, 127.0464105652137 37.50744915526325, 127.0457333334652 37.50786572933549, 127.0456605451293 37.5079164031586, 127.0448697241354 37.50847532838917, 127.0441759701307 37.50920201492291, 127.0437657993879 37.51026326732595, 127.0430540066438 37.51237232429997, 127.0413131850367 37.51710230739545, 127.0402705174165 37.51692858044005, 127.0412417112372 37.51730376330539, 127.0502725560441 37.51885264518489, 127.0509816825171 37.51746046760847, 127.0517033652953 37.51599399722007, 127.0524100612393 37.51466379457713, 127.052688960139 37.51414381252372, 127.0528078603594 37.51392250179745, 127.0546068807655 37.51058782214457, 127.0546248863461 37.51055487329568, 127.0546462092782 37.51051586179897, 127.0552952319378 37.50935330178475, 127.0561775624808 37.50777450306385, 127.05669182524 37.50685502947763)))"
362,서울특별시,강남구,대치1동,11680600,25349,12722,12627,"MULTIPOLYGON (((127.0655300172321 37.49006958228259, 127.0620202248187 37.48942006782937, 127.0599891729575 37.4890373291266, 127.0593940047512 37.48889878006832, 127.0592731167316 37.4888679082146, 127.0592104646772 37.48885190065234, 127.0587989136047 37.48874558117927, 127.0579031785485 37.48838394152899, 127.0565591748036 37.48768150139139, 127.0557253435773 37.49011533956993, 127.0554841626922 37.49081908395703, 127.0553982831312 37.49103510274755, 127.0538235965407 37.49438068370571, 127.0537362676522 37.49456062592377, 127.0533969737287 37.49525902376421, 127.0530323328993 37.49566736428729, 127.0527287653555 37.49627250169419, 127.0525102427596 37.4970538815509, 127.0556740628453 37.49721905492903, 127.0608606032655 37.49887322207154, 127.0622018523726 37.49645811688719, 127.0655300172321 37.49006958228259)))"
363,서울특별시,강남구,대치4동,11680630,20937,9914,11023,"MULTIPOLYGON (((127.0608606032655 37.49887322207154, 127.0556740628453 37.49721905492903, 127.0525102427596 37.4970538815509, 127.049294657181 37.50386482816621, 127.0490428489952 37.50439748322853, 127.05669182524 37.50685502947763, 127.0608606032655 37.49887322207154)))"
364,서울특별시,강남구,역삼1동,11680640,37277,18019,19258,"MULTIPOLYGON (((127.0471782349514 37.50397402969755, 127.0427675349784 37.50262185145928, 127.0383986760759 37.50128216679028, 127.0370441958081 37.50061643251424, 127.0384573200839 37.49753161441146, 127.0408883752856 37.49241358468067, 127.0316232575204 37.48954007672874, 127.0276351080783 37.49796430342111, 127.0264857899006 37.50036858341875, 127.0244958389723 37.50451810741976, 127.0244700492047 37.50457187505761, 127.0338873528466 37.5073920313264, 127.0437657993879 37.51026326732595, 127.0441759701307 37.50920201492291, 127.0448697241354 37.50847532838917, 127.0456605451293 37.5079164031586, 127.0457333334652 37.50786572933549, 127.0464105652137 37.50744915526325, 127.0468746925831 37.50716367374586, 127.0469889651345 37.50709313008724, 127.0472785999956 37.50690833536937, 127.0477695540725 37.50659131903346, 127.0481413075366 37.50620745245322, 127.048257280533 37.50597575837797, 127.048675262996 37.50514025817236, 127.0489297064122 37.50463080869956, 127.0471782349514 37.50397402969755)))"
365,서울특별시,강남구,역삼2동,11680650,37211,17489,19722,"MULTIPOLYGON (((127.0525102427596 37.4970538815509, 127.0527287653555 37.49627250169419, 127.0466922640252 37.49430511297226, 127.0408883752856 37.49241358468067, 127.0384573200839 37.49753161441146, 127.0370441958081 37.50061643251424, 127.0383986760759 37.50128216679028, 127.0427675349784 37.50262185145928, 127.0471782349514 37.50397402969755, 127.0490428489952 37.50439748322853, 127.049294657181 37.50386482816621, 127.0525102427596 37.4970538815509)))"
366,서울특별시,강남구,도곡1동,11680655,22618,10702,11916,"MULTIPOLYGON (((127.0413458460977 37.48557052780573, 127.0339679429088 37.48479724859385, 127.0337774785239 37.48509925625063, 127.0316232575204 37.48954007672874, 127.0408883752856 37.49241358468067, 127.0466922640252 37.49430511297226, 127.0490435995344 37.48986925062655, 127.049261726322 37.48945320359487, 127.0493990417867 37.48919120601168, 127.0498230391722 37.48838037967024, 127.0483799605779 37.4877169694774, 127.0480084597374 37.48767722921342, 127.0467475348716 37.48714789818374, 127.0453938538672 37.48653499215869, 127.0452823030646 37.48648448414102, 127.0453744643301 37.48635666794088, 127.0450351106134 37.48622928369704, 127.0442250963873 37.4859704003665, 127.0441742926673 37.48595443054452, 127.0438140899227 37.48589783189059, 127.0413458460977 37.48557052780573)))"
367,서울특별시,강남구,도곡2동,11680656,34385,15989,18396,"MULTIPOLYGON (((127.0565591748036 37.48768150139139, 127.0565210787098 37.48766102007492, 127.0517256001338 37.48485442651803, 127.0510972329071 37.48446326983662, 127.0508676252592 37.48432043273134, 127.0499139859486 37.48372753836982, 127.048101695295 37.48262433912758, 127.0478953126221 37.48249961139911, 127.046168715558 37.48149241694141, 127.045133940769 37.48088909500404, 127.0448535892886 37.48072464346596, 127.0443556740817 37.48018528712598, 127.0443100357131 37.4801332827877, 127.0439421898421 37.47971047664745, 127.0415366307098 37.48508954292947, 127.0413458460977 37.48557052780573, 127.0438140899227 37.48589783189059, 127.0441742926673 37.48595443054452, 127.0442250963873 37.4859704003665, 127.0450351106134 37.48622928369704, 127.0453744643301 37.48635666794088, 127.0452823030646 37.48648448414102, 127.0453938538672 37.48653499215869, 127.0467475348716 37.48714789818374, 127.0480084597374 37.48767722921342, 127.0483799605779 37.4877169694774, 127.0498230391722 37.48838037967024, 127.0493990417867 37.48919120601168, 127.049261726322 37.48945320359487, 127.0490435995344 37.48986925062655, 127.0466922640252 37.49430511297226, 127.0527287653555 37.49627250169419, 127.0530323328993 37.49566736428729, 127.0533969737287 37.49525902376421, 127.0537362676522 37.49456062592377, 127.0538235965407 37.49438068370571, 127.0553982831312 37.49103510274755, 127.0554841626922 37.49081908395703, 127.0557253435773 37.49011533956993, 127.0565591748036 37.48768150139139)))"
368,서울특별시,강남구,개포1동,11680660,7028,3397,3631,"MULTIPOLYGON (((127.0764100074407 37.48370494677163, 127.0758939812154 37.48244794788353, 127.0748199332816 37.48061770087686, 127.0745676088016 37.48036215750677, 127.0741069664589 37.48006755493481, 127.0735289033155 37.47953817234858, 127.0731953906564 37.47913342773077, 127.0728612525858 37.47872791373328, 127.0730128531692 37.47843872473756, 127.0733504672675 37.47785001366115, 127.0743766285862 37.47626817717369, 127.0771623877226 37.47500946525027, 127.076151731174 37.47398732260724, 127.0759435921166 37.47379503591845, 127.0739132085454 37.47285819987911, 127.0726531777392 37.47479946922746, 127.0708137529753 37.47483449027618, 127.0697580502096 37.47477656909389, 127.0692436338979 37.47388572469986, 127.0625318878364 37.47284246894814, 127.0587388939248 37.47599220717883, 127.058189919263 37.47654900096448, 127.0551967152161 37.47958550326409, 127.0547754490969 37.48002046454273, 127.0537996014574 37.48106072329887, 127.0537725619968 37.48109047430336, 127.053569595568 37.48146096070575, 127.0517256001338 37.48485442651803, 127.0565210787098 37.48766102007492, 127.0568245712582 37.48654900980491, 127.0568652341491 37.48648606701177, 127.0574459308003 37.48559927560115, 127.0576455536079 37.48531496749518, 127.0580019475346 37.48481942557483, 127.0647413957776 37.47918952344668, 127.06481062936 37.4790670353593, 127.067567916446 37.48073479441342, 127.070399370891 37.48244736350236, 127.0704759792139 37.48249369715862, 127.0724652335062 37.48395254684315, 127.0741983063173 37.48522344863346, 127.0755293523881 37.48619948864555, 127.0755895883992 37.48609494871637, 127.0764100074407 37.48370494677163)))"
369,서울특별시,강남구,개포4동,11680690,18485,9075,9410,"MULTIPOLYGON (((127.0625318878364 37.47284246894814, 127.0622804215945 37.47022579791248, 127.0621631882913 37.46964694905392, 127.0616116613502 37.46895874049018, 127.0567485528101 37.46842006132609, 127.0562066558302 37.46838535290122, 127.0545271867516 37.46852663178099, 127.0541610814936 37.46863117935794, 127.053810698328 37.46873124228762, 127.0500699309385 37.47009952506586, 127.0495805879957 37.47048749255598, 127.0503936734613 37.47103930158703, 127.0510574550327 37.4714913535671, 127.0507127069182 37.47182244814768, 127.0491520490357 37.47331891359557, 127.0450299533538 37.47728662504824, 127.044688649452 37.477966965815, 127.0445748748024 37.47819412137235, 127.0439421898421 37.47971047664745, 127.0443100357131 37.4801332827877, 127.0443556740817 37.48018528712598, 127.0448535892886 37.48072464346596, 127.045133940769 37.48088909500404, 127.046168715558 37.48149241694141, 127.0478953126221 37.48249961139911, 127.048101695295 37.48262433912758, 127.0499139859486 37.48372753836982, 127.0508676252592 37.48432043273134, 127.0510972329071 37.48446326983662, 127.0517256001338 37.48485442651803, 127.053569595568 37.48146096070575, 127.0537725619968 37.48109047430336, 127.0537996014574 37.48106072329887, 127.0547754490969 37.48002046454273, 127.0551967152161 37.47958550326409, 127.058189919263 37.47654900096448, 127.0587388939248 37.47599220717883, 127.0625318878364 37.47284246894814)))"
370,서울특별시,강남구,일원본동,11680720,24469,12003,12466,"MULTIPOLYGON (((127.0929906751923 37.47726100304872, 127.0919418528778 37.47737457728958, 127.0866879858694 37.47602905727432, 127.0855581567178 37.47554956703349, 127.0851618267097 37.47527333765135, 127.0840467565666 37.47543659623245, 127.0838722652993 37.47544568051607, 127.0830017416782 37.47538740294046, 127.0821884554423 37.47533157477234, 127.0816325535757 37.47526200545619, 127.0810230473899 37.4751697093587, 127.0803510094767 37.47488564816519, 127.0792479214745 37.47482989596271, 127.079040124138 37.47482690241954, 127.0783352301617 37.47485706345417, 127.0771623877226 37.47500946525027, 127.0743766285862 37.47626817717369, 127.0733504672675 37.47785001366115, 127.0730128531692 37.47843872473756, 127.0728612525858 37.47872791373328, 127.0731953906564 37.47913342773077, 127.0735289033155 37.47953817234858, 127.0741069664589 37.48006755493481, 127.0745676088016 37.48036215750677, 127.0748199332816 37.48061770087686, 127.0758939812154 37.48244794788353, 127.0764100074407 37.48370494677163, 127.0774490637626 37.48712375233895, 127.0818048172363 37.48867240109077, 127.0907467259579 37.4913359365121, 127.0913138796592 37.49027316589308, 127.0940940419716 37.48735219588695, 127.0941725994702 37.48720599432031, 127.095008532891 37.48282823920089, 127.0949168574511 37.48239876776614, 127.0948144775381 37.48225958780456, 127.0946204565571 37.48203934200926, 127.0943009900446 37.48164923410077, 127.0941921321459 37.48151617143235, 127.0937784358734 37.48085366178888, 127.0931049891736 37.47953059510397, 127.0930000074849 37.47855450708359, 127.0929906751923 37.47726100304872)))"
371,서울특별시,강남구,일원1동,11680730,16556,8079,8477,"MULTIPOLYGON (((127.096740694648 37.49583086240224, 127.1019653063676 37.49363781211493, 127.1001703019364 37.49308191989109, 127.0992179540071 37.49281391782823, 127.0982907143921 37.4926135956215, 127.0973516008253 37.49248089993216, 127.0964736411328 37.49235727508255, 127.0960764176527 37.49230143930575, 127.0951016565246 37.49216442153669, 127.0925258580224 37.49180065417695, 127.0922764720254 37.49176486598423, 127.0915253558222 37.49155495809836, 127.0913137924009 37.4914954486046, 127.0907467259579 37.4913359365121, 127.0818048172363 37.48867240109077, 127.0798548457948 37.49292916699407, 127.0796165201162 37.49366536235141, 127.0800681596739 37.49382274187142, 127.0806384869245 37.49402147185578, 127.0810583512 37.49416718024161, 127.0811218696476 37.49418768610418, 127.0867017722757 37.49596207307238, 127.0884580632183 37.49650405463593, 127.0904700026152 37.49747324942179, 127.096740694648 37.49583086240224)))"
372,서울특별시,강남구,일원2동,11680740,18162,8768,9394,"MULTIPOLYGON (((127.08362899995 37.49926446356682, 127.0904700026152 37.49747324942179, 127.0884580632183 37.49650405463593, 127.0867017722757 37.49596207307238, 127.0811218696476 37.49418768610418, 127.0810583512 37.49416718024161, 127.0806384869245 37.49402147185578, 127.0800681596739 37.49382274187142, 127.0796165201162 37.49366536235141, 127.0798548457948 37.49292916699407, 127.0818048172363 37.48867240109077, 127.0774490637626 37.48712375233895, 127.0780408180883 37.48786831662435, 127.0772103706978 37.49058520722318, 127.076501972885 37.49200300846758, 127.0762084948963 37.49258941564971, 127.0754382409967 37.49233583904982, 127.0749446290844 37.49217248516213, 127.0750003474878 37.49206307376511, 127.072778656426 37.49131162750591, 127.0724019955132 37.49134592808043, 127.0718359683574 37.49302544231828, 127.0724522297464 37.49356848998151, 127.0734318510361 37.49451952664224, 127.0735793646319 37.49466321063776, 127.0736736316823 37.49481261793647, 127.0737916902456 37.49499973379852, 127.0738225401156 37.49504945599833, 127.0738512376544 37.4950957182135, 127.0741193965238 37.49618282502571, 127.0742396513955 37.49667111997182, 127.0743029929679 37.49747017908349, 127.0742811325514 37.49774583099993, 127.074274469848 37.4978244236523, 127.074184819954 37.49848378371496, 127.0741781884554 37.49852995453114, 127.0740744776614 37.49886308398025, 127.0746546374578 37.50029608371127, 127.075490888551 37.50120046540529, 127.08362899995 37.49926446356682)))"
373,서울특별시,강남구,수서동,11680750,16065,7379,8686,"MULTIPOLYGON (((127.1081396454639 37.48930959967124, 127.1101917157413 37.48687888267508, 127.1115628692106 37.484558106389, 127.1122757938946 37.48353852793635, 127.1121766422593 37.48343567238243, 127.1119777101599 37.48331890553752, 127.111740381725 37.48317960337992, 127.1113897088355 37.48304888033852, 127.1110976000359 37.4829408822355, 127.1110354206454 37.48293504402488, 127.1105108919347 37.48306765530392, 127.1100323915758 37.48318862634042, 127.1082832579893 37.48308819695277, 127.1074485840395 37.48291303998278, 127.1069387401367 37.48280656229633, 127.1067443125029 37.48279667543358, 127.1065592273884 37.48278727184669, 127.1056029012069 37.48274136325974, 127.1049525593638 37.48342525898867, 127.1039875173823 37.48477858030975, 127.1026208466016 37.4849396170418, 127.1022264262334 37.48477334931221, 127.099493497381 37.48318491899704, 127.0988621476619 37.48279969765723, 127.0985690240758 37.4826206827949, 127.0979831192357 37.48219954217505, 127.0976854986077 37.48180532367023, 127.0973627489302 37.48082511792025, 127.0972881458526 37.48037074305979, 127.0974276347738 37.47992960870276, 127.0974762356127 37.47917262855285, 127.0973428435394 37.47808050943745, 127.0957591682722 37.47760177298736, 127.0929906751923 37.47726100304872, 127.0930000074849 37.47855450708359, 127.0931049891736 37.47953059510397, 127.0937784358734 37.48085366178888, 127.0941921321459 37.48151617143235, 127.0943009900446 37.48164923410077, 127.0946204565571 37.48203934200926, 127.0948144775381 37.48225958780456, 127.0949168574511 37.48239876776614, 127.095008532891 37.48282823920089, 127.0941725994702 37.48720599432031, 127.0940940419716 37.48735219588695, 127.0913138796592 37.49027316589308, 127.0907467259579 37.4913359365121, 127.0913137924009 37.4914954486046, 127.0915253558222 37.49155495809836, 127.0922764720254 37.49176486598423, 127.0925258580224 37.49180065417695, 127.0951016565246 37.49216442153669, 127.0960764176527 37.49230143930575, 127.0964736411328 37.49235727508255, 127.0973516008253 37.49248089993216, 127.0982907143921 37.4926135956215, 127.0992179540071 37.49281391782823, 127.1001703019364 37.49308191989109, 127.1019653063676 37.49363781211493, 127.1021169381763 37.49357603878993, 127.1022203878058 37.49353388794119, 127.1036471590645 37.49273309101707, 127.1043699172039 37.4922972262752, 127.1047990259013 37.4920372665574, 127.1056825352073 37.491414898641, 127.1081396454639 37.48930959967124)))"
374,서울특별시,강남구,세곡동,11680700,45109,21514,23595,"MULTIPOLYGON (((127.1110354206454 37.48293504402488, 127.1110900690549 37.48289466254922, 127.1116954237647 37.48244033725231, 127.114589692829 37.47852459047009, 127.1187995086813 37.47279633333915, 127.1196052885649 37.4716823642653, 127.1205378174029 37.47037838206509, 127.121514010366 37.46881876933388, 127.1221821195014 37.46751730536409, 127.1222978617648 37.46676441235726, 127.1224236952005 37.46585956292014, 127.1224034651138 37.46559641185152, 127.1223630223878 37.46545116706536, 127.1222933718581 37.46521354246407, 127.1218470770104 37.46502865992422, 127.1174604897814 37.46217165665753, 127.1171802774831 37.46182259616151, 127.1170799523129 37.46153946714389, 127.1169930438348 37.46125976164172, 127.1169526008446 37.46101288125212, 127.1169290269432 37.46078633628875, 127.1169000813773 37.46050231172587, 127.1167826527096 37.45913973932263, 127.1167471318756 37.45859429669539, 127.1156017161552 37.45859508243112, 127.11364393448 37.45973794163942, 127.1132459337698 37.46003521771895, 127.1128782520239 37.46048469749534, 127.1130085962848 37.46057624363328, 127.1132183601776 37.46072354677638, 127.1132954491602 37.46077732225134, 127.1133676646118 37.46082782328837, 127.1133967784565 37.4610710984083, 127.1120203931218 37.4615601446767, 127.1112839241509 37.46170757672408, 127.10826139671 37.46216799218958, 127.1066416528897 37.46247527781033, 127.1063070306596 37.46253838586748, 127.1047330603367 37.46214892406394, 127.1044803356716 37.46102136984126, 127.1039558356105 37.46010585236642, 127.10350183559 37.45962547869016, 127.1005572225059 37.45905108024201, 127.0982144531008 37.45879413651465, 127.0968482697306 37.45960747433698, 127.0963176312864 37.46143202137049, 127.0962571265207 37.46164254518388, 127.0960864720589 37.46222897701581, 127.0959959704971 37.46249907760831, 127.0950165546593 37.46365736109222, 127.094035920871 37.46398750180195, 127.0933601800066 37.46439642674009, 127.0887645194545 37.46807387004427, 127.0862116656786 37.47036347997633, 127.0851985860219 37.47156208288457, 127.0849022471739 37.47211121725942, 127.0844915817287 37.47287221121245, 127.0850691436286 37.47494136694652, 127.0851618267097 37.47527333765135, 127.0855581567178 37.47554956703349, 127.0866879858694 37.47602905727432, 127.0919418528778 37.47737457728958, 127.0929906751923 37.47726100304872, 127.0957591682722 37.47760177298736, 127.0973428435394 37.47808050943745, 127.0974762356127 37.47917262855285, 127.0974276347738 37.47992960870276, 127.0972881458526 37.48037074305979, 127.0973627489302 37.48082511792025, 127.0976854986077 37.48180532367023, 127.0979831192357 37.48219954217505, 127.0985690240758 37.4826206827949, 127.0988621476619 37.48279969765723, 127.099493497381 37.48318491899704, 127.1022264262334 37.48477334931221, 127.1026208466016 37.4849396170418, 127.1039875173823 37.48477858030975, 127.1049525593638 37.48342525898867, 127.1056029012069 37.48274136325974, 127.1065592273884 37.48278727184669, 127.1067443125029 37.48279667543358, 127.1069387401367 37.48280656229633, 127.1074485840395 37.48291303998278, 127.1082832579893 37.48308819695277, 127.1100323915758 37.48318862634042, 127.1105108919347 37.48306765530392, 127.1110354206454 37.48293504402488)))"
375,서울특별시,강남구,압구정동,11680545,27767,12751,15016,"MULTIPOLYGON (((127.0459616923422 37.53250292666626, 127.0439954693564 37.52756832006396, 127.0437900305435 37.52705285742561, 127.0418228119202 37.52751709763201, 127.041203043954 37.52768282131209, 127.0407973456897 37.52779129908323, 127.0401771770044 37.52642118899021, 127.0395409018271 37.52464078597098, 127.0393257098981 37.52403847236067, 127.0391223069504 37.52346851790512, 127.0391254195484 37.52319248992893, 127.0391272200167 37.52307641137587, 127.0391277621862 37.52304162567435, 127.0391780751905 37.52290539552294, 127.0390613257567 37.52293229787755, 127.0388367071588 37.52298405117769, 127.0382648949681 37.52280492602354, 127.0374086055561 37.52253567535443, 127.033865598605 37.52142096466066, 127.0327898173994 37.52107983229733, 127.0305175885806 37.52035875098888, 127.0280781532315 37.519584003369, 127.0281624092873 37.52113467160709, 127.0281745300172 37.5213442851718, 127.0282460366683 37.52256928739047, 127.028373454163 37.52457531138199, 127.0285558436765 37.52555133351237, 127.0285909585933 37.52593768707884, 127.0286215941498 37.52661275908329, 127.028564254372 37.52730820109505, 127.02834411019 37.52721391113644, 127.0283124841652 37.52729378004371, 127.0279989309038 37.52777362526999, 127.0274071192062 37.52829629747193, 127.0268695481673 37.52874144214648, 127.0265915908875 37.52897148956885, 127.0261755354305 37.52931552642519, 127.0256950652302 37.52979018872576, 127.0252430503104 37.53023679609947, 127.0244236709124 37.5313997881221, 127.0243550673817 37.53149849850466, 127.0242429860664 37.53166029070537, 127.0215649184989 37.5355309658779, 127.0256997843901 37.53786411011562, 127.028283460348 37.5385279110979, 127.0283265484259 37.5385393501206, 127.0298568459488 37.53886430616576, 127.0348628173433 37.53692256055055, 127.0378156485108 37.53577704182295, 127.0380050046339 37.53570116771692, 127.0391850762318 37.53522693434535, 127.0459616923422 37.53250292666626)))"
376,서울특별시,강남구,청담동,11680565,30132,14170,15962,"MULTIPOLYGON (((127.0565665637636 37.52910117290874, 127.0602520021255 37.52752180766007, 127.0652649061698 37.52560351988906, 127.0619436219763 37.52213798538031, 127.0615485299137 37.52172640214491, 127.0606249009166 37.52126633351427, 127.0605638979865 37.52123597240857, 127.0603212197725 37.52115060492256, 127.0588290926506 37.52062788745408, 127.0584000527219 37.52047759810067, 127.058307490992 37.52044566664458, 127.0580809051947 37.52036820375027, 127.057769625831 37.5202622559428, 127.0573136325606 37.52010844377664, 127.0569954100586 37.52004410246758, 127.0562207746221 37.51988801787054, 127.0511273482708 37.51900121449547, 127.0502725560441 37.51885264518489, 127.0412417112372 37.51730376330539, 127.0391780751905 37.52290539552294, 127.0391277621862 37.52304162567435, 127.0391272200167 37.52307641137587, 127.0391254195484 37.52319248992893, 127.0391223069504 37.52346851790512, 127.0393257098981 37.52403847236067, 127.0395409018271 37.52464078597098, 127.0401771770044 37.52642118899021, 127.0407973456897 37.52779129908323, 127.041203043954 37.52768282131209, 127.0418228119202 37.52751709763201, 127.0437900305435 37.52705285742561, 127.0439954693564 37.52756832006396, 127.0459616923422 37.53250292666626, 127.0490584255916 37.53255215318233, 127.0565665637636 37.52910117290874)))"
377,서울특별시,강남구,대치2동,11680610,38853,19737,19116,"MULTIPOLYGON (((127.0688034980296 37.51000278936198, 127.0694250446776 37.50644871142377, 127.0697125520678 37.50538776693556, 127.0698064500091 37.5050444657274, 127.0699935703683 37.50480855825788, 127.0700194290874 37.50477596008535, 127.071212490393 37.50351614022986, 127.0724885087333 37.50261751264852, 127.0726594105102 37.50249721362136, 127.0729119603448 37.50231981097726, 127.0731813261133 37.50213061115677, 127.075490888551 37.50120046540529, 127.0746546374578 37.50029608371127, 127.0740744776614 37.49886308398025, 127.0741781884554 37.49852995453114, 127.074184819954 37.49848378371496, 127.074274469848 37.4978244236523, 127.0742811325514 37.49774583099993, 127.0743029929679 37.49747017908349, 127.0742396513955 37.49667111997182, 127.0741193965238 37.49618282502571, 127.0738512376544 37.4950957182135, 127.0738225401156 37.49504945599833, 127.0737916902456 37.49499973379852, 127.0736736316823 37.49481261793647, 127.0735793646319 37.49466321063776, 127.0734318510361 37.49451952664224, 127.0724522297464 37.49356848998151, 127.0718359683574 37.49302544231828, 127.0685295007108 37.49101126215645, 127.0680002787413 37.49075184526831, 127.0678139193826 37.49066049572792, 127.0672078359829 37.49044645705484, 127.0671640680698 37.49043502969188, 127.0664336815713 37.49025034860717, 127.0663479157585 37.4902305644177, 127.0655300172321 37.49006958228259, 127.0622018523726 37.49645811688719, 127.0608606032655 37.49887322207154, 127.05669182524 37.50685502947763, 127.0604958370752 37.50801960246717, 127.0665493816083 37.5099370775886, 127.0673659706454 37.51008540634464, 127.0684631425072 37.51028434761371, 127.0688034980296 37.51000278936198)))"
378,서울특별시,강남구,개포2동,11680670,19915,9617,10298,"MULTIPOLYGON (((127.0774490637626 37.48712375233895, 127.0764100074407 37.48370494677163, 127.0755895883992 37.48609494871637, 127.0755293523881 37.48619948864555, 127.0741983063173 37.48522344863346, 127.0724652335062 37.48395254684315, 127.0704759792139 37.48249369715862, 127.070399370891 37.48244736350236, 127.067567916446 37.48073479441342, 127.06481062936 37.4790670353593, 127.0647413957776 37.47918952344668, 127.0580019475346 37.48481942557483, 127.0576455536079 37.48531496749518, 127.0574459308003 37.48559927560115, 127.0568652341491 37.48648606701177, 127.0568245712582 37.48654900980491, 127.0565210787098 37.48766102007492, 127.0565591748036 37.48768150139139, 127.0579031785485 37.48838394152899, 127.0587989136047 37.48874558117927, 127.0592104646772 37.48885190065234, 127.0592731167316 37.4888679082146, 127.0593940047512 37.48889878006832, 127.0599891729575 37.4890373291266, 127.0620202248187 37.48942006782937, 127.0655300172321 37.49006958228259, 127.0663479157585 37.4902305644177, 127.0664336815713 37.49025034860717, 127.0671640680698 37.49043502969188, 127.0672078359829 37.49044645705484, 127.0678139193826 37.49066049572792, 127.0680002787413 37.49075184526831, 127.0685295007108 37.49101126215645, 127.0718359683574 37.49302544231828, 127.0724019955132 37.49134592808043, 127.072778656426 37.49131162750591, 127.0750003474878 37.49206307376511, 127.0749446290844 37.49217248516213, 127.0754382409967 37.49233583904982, 127.0762084948963 37.49258941564971, 127.076501972885 37.49200300846758, 127.0772103706978 37.49058520722318, 127.0780408180883 37.48786831662435, 127.0774490637626 37.48712375233895)))"
379,서울특별시,송파구,풍납1동,11710510,15697,7775,7922,"MULTIPOLYGON (((127.1232114342576 37.53852869389421, 127.122432618233 37.53626492893626, 127.1212608373923 37.53310755020215, 127.1198155661053 37.5335310577752, 127.11225147477 37.53567873225423, 127.1118370479025 37.53579229364836, 127.1112047917289 37.53596413035751, 127.1109359289659 37.53603720111096, 127.1098393685474 37.5360459769421, 127.1041582268374 37.53600340990382, 127.1095643777354 37.54346998109902, 127.1171171858497 37.54134497994282, 127.1183897613333 37.54096376995346, 127.1184317992535 37.54095105247117, 127.1185002979239 37.54093032629324, 127.1185978805054 37.54089328033719, 127.1190836812091 37.54070687076531, 127.1195150545117 37.54046489554321, 127.1195985474329 37.54040807268806, 127.1197948184326 37.54027286152222, 127.1204649646042 37.53981108966332, 127.1214171353589 37.53926657264082, 127.1214793216588 37.53923118647219, 127.1216101192163 37.53915677511969, 127.1232114342576 37.53852869389421)))"
380,서울특별시,송파구,풍납2동,11710520,24762,11763,12999,"MULTIPOLYGON (((127.1212608373923 37.53310755020215, 127.1207198282461 37.53131725019986, 127.1191613156011 37.52806564603419, 127.1164046623389 37.52396341162023, 127.1061590063532 37.52390148305057, 127.1043389265397 37.52422225888794, 127.0989571712764 37.52795365256429, 127.1032018006623 37.53466506706074, 127.1041582268374 37.53600340990382, 127.1098393685474 37.5360459769421, 127.1109359289659 37.53603720111096, 127.1112047917289 37.53596413035751, 127.1118370479025 37.53579229364836, 127.11225147477 37.53567873225423, 127.1198155661053 37.5335310577752, 127.1212608373923 37.53310755020215)))"
381,서울특별시,송파구,거여1동,11710531,13273,6768,6505,"MULTIPOLYGON (((127.1465802956663 37.49798005681577, 127.1454554897533 37.49545587337122, 127.1436649186376 37.49116037518095, 127.1427161856682 37.48912145384832, 127.1425609555125 37.48917003742154, 127.1423744290411 37.48942119858969, 127.1424782705806 37.49005203838314, 127.1424681896635 37.49049388784355, 127.1423784519848 37.4909265825868, 127.1420953899187 37.49103998132843, 127.141826699951 37.49165303876617, 127.1414930265991 37.49167965526603, 127.1377611922997 37.49043048267845, 127.1366743717028 37.48915278231174, 127.1358328593154 37.48952115478401, 127.1358956728212 37.49023032752987, 127.1372804588158 37.49146706188071, 127.1373146623949 37.49309926420012, 127.1378431311728 37.4936398986704, 127.1379625361625 37.49430226701651, 127.1392761496072 37.49565723793896, 127.1398112669755 37.49538058937702, 127.140006245501 37.4957969913148, 127.1407568114664 37.49740139398487, 127.1419731457833 37.4994286620863, 127.1465802956663 37.49798005681577)))"
382,서울특별시,송파구,거여2동,11710532,17047,8375,8672,"MULTIPOLYGON (((127.1489717686615 37.49628361259846, 127.1503223052429 37.49536033986715, 127.1509236456662 37.49483031407676, 127.1510614597012 37.49469100993485, 127.1512943764358 37.4944506542344, 127.1515122020831 37.49422534326767, 127.1515687589116 37.494158448666, 127.1518144057206 37.49386229090455, 127.1524992427851 37.49296708033973, 127.1513135622125 37.49267903985675, 127.1503284350295 37.49205078383454, 127.1504878487159 37.49159523321502, 127.1506517386385 37.49143800006475, 127.1503570547891 37.49120097103639, 127.1496535184337 37.49047712795636, 127.1484173022887 37.49005440792038, 127.1472996922307 37.48901514289401, 127.147328254217 37.48888213907566, 127.1472023014881 37.48820067980502, 127.1468116725731 37.48745231973808, 127.1466983492468 37.48733050406805, 127.1463054025978 37.48725738596841, 127.1459901738039 37.48727313420072, 127.1457164209823 37.48709770676256, 127.1452743016731 37.48736701832512, 127.1450890763888 37.48742611522433, 127.1446806781283 37.48740673781204, 127.1445789747758 37.48742636736584, 127.1445126537227 37.48752623185862, 127.1444770660152 37.48773875474257, 127.1442129089295 37.48815637720065, 127.1443350082142 37.48846481209192, 127.1432580468127 37.48876076557162, 127.1430374961683 37.4889780572768, 127.1427161856682 37.48912145384832, 127.1436649186376 37.49116037518095, 127.1454554897533 37.49545587337122, 127.1465802956663 37.49798005681577, 127.1489717686615 37.49628361259846)))"
383,서울특별시,송파구,마천1동,11710540,20833,10639,10194,"MULTIPOLYGON (((127.1600954335267 37.4971600501592, 127.1600540216903 37.49459554471811, 127.1600512830558 37.4945233827011, 127.1600483319864 37.49444567758847, 127.1600288674894 37.49438454339096, 127.1599772265002 37.49422238461501, 127.1598061009738 37.49376106990374, 127.1597435301868 37.49360427780215, 127.15841848445 37.49069555539241, 127.1582013359859 37.49045857260921, 127.1576788696482 37.49016640067002, 127.1563857036063 37.49093553727543, 127.1524992427851 37.49296708033973, 127.1518144057206 37.49386229090455, 127.1515687589116 37.494158448666, 127.1515122020831 37.49422534326767, 127.1512943764358 37.4944506542344, 127.1510614597012 37.49469100993485, 127.1509236456662 37.49483031407676, 127.1503223052429 37.49536033986715, 127.1489717686615 37.49628361259846, 127.1568550012188 37.49838666863474, 127.1600954335267 37.4971600501592)))"
384,서울특별시,송파구,마천2동,11710550,20315,10303,10012,"MULTIPOLYGON (((127.1600954335267 37.4971600501592, 127.1568550012188 37.49838666863474, 127.1489717686615 37.49628361259846, 127.1465802956663 37.49798005681577, 127.1419731457833 37.4994286620863, 127.1443721771709 37.50438770568849, 127.1450629425637 37.50365296257219, 127.1450994787689 37.50362118127221, 127.1451339472458 37.50359120728861, 127.145236894176 37.50350250614557, 127.1456035245771 37.50343037191794, 127.1460521259897 37.50336974740767, 127.1476861402132 37.50326991283001, 127.1486434616396 37.50372901451259, 127.1492874496437 37.50407344566066, 127.1501226532437 37.50450970356701, 127.1508401552456 37.50410508620834, 127.1516730238776 37.50337293524503, 127.1517928777277 37.50325462431837, 127.1519032457501 37.50314993193299, 127.1520612360375 37.50311030481463, 127.1521509448736 37.50308816205816, 127.1522539591441 37.50309497318993, 127.1526323395424 37.50311999959348, 127.152824965447 37.50305747054195, 127.1530130432113 37.50290929843491, 127.1532131770671 37.50275214779723, 127.153468284283 37.50274914676881, 127.1535964545272 37.50274763794124, 127.1537186987714 37.50275025065733, 127.1539634056512 37.50275547454709, 127.1541517920882 37.50269180420248, 127.1545646942726 37.50255104783396, 127.1553175316407 37.50229410531974, 127.1561653206402 37.50200472306381, 127.1562092652468 37.50198971709365, 127.1564712232407 37.50190086665547, 127.1566485710017 37.50208503389678, 127.1576169718496 37.50308835655733, 127.1578690575557 37.50301134536362, 127.1605525273806 37.50114537932439, 127.1613782187471 37.50025065997565, 127.1613772871822 37.49983063046925, 127.1613761586629 37.49961204680415, 127.1605631968567 37.49769544453614, 127.1600954335267 37.4971600501592)))"
385,서울특별시,송파구,방이1동,11710561,16515,7983,8532,"MULTIPOLYGON (((127.1279889313365 37.51173519797379, 127.1239042100538 37.50537105985097, 127.1224326635328 37.50537650487396, 127.1166594046833 37.50776116180219, 127.1167584519213 37.50791489470366, 127.1210278158119 37.51458835985016, 127.1279889313365 37.51173519797379)))"
386,서울특별시,송파구,방이2동,11710562,26209,12561,13648,"MULTIPOLYGON (((127.1210278158119 37.51458835985016, 127.1167584519213 37.50791489470366, 127.1166594046833 37.50776116180219, 127.1153507281369 37.50853320393706, 127.1122452820173 37.51036182466756, 127.1111622955332 37.51078846638134, 127.1101555154196 37.51118419775942, 127.108090578093 37.51197503871999, 127.106649113986 37.51551272609658, 127.1127592671797 37.51771922433603, 127.1125520936565 37.51751516236084, 127.1127447904623 37.51744354140832, 127.1181547946955 37.51544784489008, 127.1186458233383 37.51526690606984, 127.1190277429336 37.5151261744846, 127.1204710475824 37.51473760210482, 127.1210278158119 37.51458835985016)))"
387,서울특별시,송파구,오륜동,11710566,18917,9285,9632,"MULTIPOLYGON (((127.1287418613178 37.52379095793577, 127.1339083832697 37.52154020710932, 127.1394184346398 37.51913813670537, 127.1408303468887 37.51850585380578, 127.1432054507867 37.51744381494846, 127.1446130522717 37.51696019781758, 127.1448793584181 37.51680136801966, 127.1454081294661 37.51648599353775, 127.145404621752 37.51633049846601, 127.1453986567023 37.51609622618857, 127.1435243959871 37.51268902694083, 127.142584782758 37.5127541554364, 127.1420614099831 37.51279046376553, 127.141125307265 37.51232372030164, 127.1403757491365 37.51021759347891, 127.1403373840361 37.5101059333082, 127.1402695881419 37.50990247907818, 127.1402460638632 37.50983186695919, 127.1399719656205 37.50859391438829, 127.1402267429743 37.50839417575327, 127.136362171468 37.50836991035361, 127.1279889313365 37.51173519797379, 127.1210278158119 37.51458835985016, 127.1204710475824 37.51473760210482, 127.1190277429336 37.5151261744846, 127.1186458233383 37.51526690606984, 127.1181547946955 37.51544784489008, 127.1127447904623 37.51744354140832, 127.1125520936565 37.51751516236084, 127.1127592671797 37.51771922433603, 127.1164046623389 37.52396341162023, 127.1191613156011 37.52806564603419, 127.1287418613178 37.52379095793577)))"
388,서울특별시,송파구,오금동,11710570,40959,19968,20991,"MULTIPOLYGON (((127.1402267429743 37.50839417575327, 127.1412831267495 37.50694292106559, 127.1411608083596 37.50630774530273, 127.1409347599753 37.5057019440223, 127.1410433699366 37.50556734124606, 127.141135441717 37.50545395934768, 127.1430116789957 37.50467095239281, 127.1433984393645 37.50451676193346, 127.1435614565507 37.50445177904554, 127.1443721771709 37.50438770568849, 127.1419731457833 37.4994286620863, 127.1407568114664 37.49740139398487, 127.140006245501 37.4957969913148, 127.1398112669755 37.49538058937702, 127.1392761496072 37.49565723793896, 127.1349819909419 37.49781991410643, 127.1321527191596 37.49952691678423, 127.131038907251 37.5001179905279, 127.1306774139967 37.5003098785192, 127.1305163848165 37.50041641167383, 127.1281362359763 37.5019987195682, 127.1239042100538 37.50537105985097, 127.1279889313365 37.51173519797379, 127.136362171468 37.50836991035361, 127.1402267429743 37.50839417575327)))"
389,서울특별시,송파구,송파1동,11710580,26152,12338,13814,"MULTIPOLYGON (((127.1166594046833 37.50776116180219, 127.1151267124171 37.50531917975604, 127.1147555699735 37.50476470578792, 127.1141297293545 37.50408326338054, 127.1138082085721 37.50376448211281, 127.1135074349022 37.50354155905729, 127.1132242383778 37.50333217263522, 127.1131847856358 37.50330387592652, 127.1130558066867 37.5032228168682, 127.1126110498428 37.50294370397768, 127.1119833069791 37.50263630679893, 127.1114406904839 37.5024125631004, 127.1113262721533 37.50237498031439, 127.1111350363173 37.50231240762005, 127.1106655941602 37.50215988429107, 127.1101460378273 37.50199141809981, 127.1057013650099 37.50650511347083, 127.1040264528227 37.50874929056749, 127.1046426890645 37.50924410375093, 127.108090578093 37.51197503871999, 127.1101555154196 37.51118419775942, 127.1111622955332 37.51078846638134, 127.1122452820173 37.51036182466756, 127.1153507281369 37.50853320393706, 127.1166594046833 37.50776116180219)))"
390,서울특별시,송파구,송파2동,11710590,20889,10091,10798,"MULTIPOLYGON (((127.1224326635328 37.50537650487396, 127.1216619780398 37.50227448311946, 127.1198367855471 37.50090869458292, 127.1187647110296 37.5002525818561, 127.11846997122 37.5000727821615, 127.1183254560143 37.49998781269448, 127.1175246593115 37.49956173600005, 127.1165075149846 37.49902310178194, 127.1149285328367 37.49821012007701, 127.1147956097509 37.49820622459025, 127.111622254856 37.50039636484431, 127.1101460378273 37.50199141809981, 127.1106655941602 37.50215988429107, 127.1111350363173 37.50231240762005, 127.1113262721533 37.50237498031439, 127.1114406904839 37.5024125631004, 127.1119833069791 37.50263630679893, 127.1126110498428 37.50294370397768, 127.1130558066867 37.5032228168682, 127.1131847856358 37.50330387592652, 127.1132242383778 37.50333217263522, 127.1135074349022 37.50354155905729, 127.1138082085721 37.50376448211281, 127.1141297293545 37.50408326338054, 127.1147555699735 37.50476470578792, 127.1151267124171 37.50531917975604, 127.1166594046833 37.50776116180219, 127.1224326635328 37.50537650487396)))"
391,서울특별시,송파구,석촌동,11710600,34278,16451,17827,"MULTIPOLYGON (((127.1101460378273 37.50199141809981, 127.111622254856 37.50039636484431, 127.110593723683 37.50006961553686, 127.1096350259931 37.5009971067566, 127.0981502347712 37.4975863797091, 127.0976187442155 37.49742572817961, 127.0973441072281 37.49694254158547, 127.0968677194115 37.49710867823862, 127.0965634629628 37.49721479339843, 127.0966093867316 37.49787857740967, 127.0969402317295 37.50236285007642, 127.0970094582438 37.50316529703617, 127.0970501401999 37.50363526537859, 127.0970780399962 37.50395534794762, 127.0973137318573 37.50653855991121, 127.0976733565481 37.50647555262493, 127.098025637433 37.50645309126243, 127.0984619228698 37.50645682853227, 127.0987545823686 37.50648825652259, 127.0989156513198 37.50650569141455, 127.0990825867151 37.50653055878201, 127.0994187415312 37.5065806340584, 127.0998770541763 37.50669936418885, 127.1002857550466 37.50683707857058, 127.1006555054085 37.50698705446306, 127.1011783787755 37.50719951387946, 127.1021420708801 37.50762978291945, 127.1026485011417 37.50787710813362, 127.1029926976849 37.50804726953614, 127.1040264528227 37.50874929056749, 127.1057013650099 37.50650511347083, 127.1101460378273 37.50199141809981)))"
392,서울특별시,송파구,삼전동,11710610,32823,15647,17176,"MULTIPOLYGON (((127.0973137318573 37.50653855991121, 127.0970780399962 37.50395534794762, 127.0970501401999 37.50363526537859, 127.0970094582438 37.50316529703617, 127.0969402317295 37.50236285007642, 127.0966093867316 37.49787857740967, 127.0965634629628 37.49721479339843, 127.0968677194115 37.49710867823862, 127.0973441072281 37.49694254158547, 127.096740694648 37.49583086240224, 127.0904700026152 37.49747324942179, 127.08362899995 37.49926446356682, 127.0907226274496 37.50753212845004, 127.0973137318573 37.50653855991121)))"
393,서울특별시,송파구,가락본동,11710620,27910,13846,14064,"MULTIPOLYGON (((127.1239042100538 37.50537105985097, 127.1281362359763 37.5019987195682, 127.1276100157312 37.50145624412206, 127.1273406309025 37.50116808743834, 127.127217166866 37.50101513253504, 127.1269941590789 37.50073884630039, 127.1266448977663 37.50030508940095, 127.1233476013886 37.49497520676896, 127.1250752728041 37.49292697491146, 127.1262552217649 37.49151104017955, 127.1210833187137 37.48899787002044, 127.1184347733529 37.49251636235878, 127.1166689975385 37.4948210279937, 127.1156791088223 37.49593099310727, 127.115524079103 37.4961051275416, 127.1152472868531 37.49641626887181, 127.1152232554352 37.49644328554038, 127.1146273841414 37.49723454163142, 127.1146431773543 37.49732585602821, 127.1147956097509 37.49820622459025, 127.1149285328367 37.49821012007701, 127.1165075149846 37.49902310178194, 127.1175246593115 37.49956173600005, 127.1183254560143 37.49998781269448, 127.11846997122 37.5000727821615, 127.1187647110296 37.5002525818561, 127.1198367855471 37.50090869458292, 127.1216619780398 37.50227448311946, 127.1224326635328 37.50537650487396, 127.1239042100538 37.50537105985097)))"
394,서울특별시,송파구,가락1동,11710631,27207,13225,13982,"MULTIPOLYGON (((127.111622254856 37.50039636484431, 127.1147956097509 37.49820622459025, 127.1146431773543 37.49732585602821, 127.1146273841414 37.49723454163142, 127.1152232554352 37.49644328554038, 127.1152472868531 37.49641626887181, 127.115524079103 37.4961051275416, 127.1156791088223 37.49593099310727, 127.1166689975385 37.4948210279937, 127.1184347733529 37.49251636235878, 127.1081396454639 37.48930959967124, 127.1056825352073 37.491414898641, 127.1047990259013 37.4920372665574, 127.1043699172039 37.4922972262752, 127.1036471590645 37.49273309101707, 127.1022203878058 37.49353388794119, 127.1021169381763 37.49357603878993, 127.1019653063676 37.49363781211493, 127.096740694648 37.49583086240224, 127.0973441072281 37.49694254158547, 127.0976187442155 37.49742572817961, 127.0981502347712 37.4975863797091, 127.1096350259931 37.5009971067566, 127.110593723683 37.50006961553686, 127.111622254856 37.50039636484431)))"
395,서울특별시,송파구,가락2동,11710632,33915,16623,17292,"MULTIPOLYGON (((127.1392761496072 37.49565723793896, 127.1379625361625 37.49430226701651, 127.1335513819617 37.49053120588665, 127.1303620744573 37.49284561247085, 127.1301887609431 37.49296432037772, 127.129905208458 37.49315853241087, 127.1296135123619 37.49322183223578, 127.128838983885 37.49287914416405, 127.1287169443547 37.49282467891652, 127.1280406869279 37.49246538664266, 127.1268468687812 37.49183066788991, 127.1262552217649 37.49151104017955, 127.1250752728041 37.49292697491146, 127.1233476013886 37.49497520676896, 127.1266448977663 37.50030508940095, 127.1269941590789 37.50073884630039, 127.127217166866 37.50101513253504, 127.1273406309025 37.50116808743834, 127.1276100157312 37.50145624412206, 127.1281362359763 37.5019987195682, 127.1305163848165 37.50041641167383, 127.1306774139967 37.5003098785192, 127.131038907251 37.5001179905279, 127.1321527191596 37.49952691678423, 127.1349819909419 37.49781991410643, 127.1392761496072 37.49565723793896)))"
396,서울특별시,송파구,문정1동,11710641,21380,10597,10783,"MULTIPOLYGON (((127.1335513819617 37.49053120588665, 127.1298092567263 37.48724527987763, 127.1263976004645 37.48280772602676, 127.1241667447737 37.48236582453692, 127.1210833187137 37.48899787002044, 127.1262552217649 37.49151104017955, 127.1268468687812 37.49183066788991, 127.1280406869279 37.49246538664266, 127.1287169443547 37.49282467891652, 127.128838983885 37.49287914416405, 127.1296135123619 37.49322183223578, 127.129905208458 37.49315853241087, 127.1301887609431 37.49296432037772, 127.1303620744573 37.49284561247085, 127.1335513819617 37.49053120588665)))"
397,서울특별시,송파구,문정2동,11710642,30038,14002,16036,"MULTIPOLYGON (((127.1210833187137 37.48899787002044, 127.1241667447737 37.48236582453692, 127.1246853957417 37.48154264459909, 127.1250694681803 37.48093206286057, 127.1253389067386 37.48038390450736, 127.1254051963763 37.48023456928637, 127.1257791305052 37.47938847138944, 127.1264853652642 37.47753276669958, 127.1270298359131 37.47594090987345, 127.1268975349013 37.4735054910754, 127.1265892914039 37.46885064813597, 127.1257733573173 37.46920527569252, 127.1250666641976 37.46890107776615, 127.1238272606048 37.46629894967226, 127.1222933718581 37.46521354246407, 127.1223630223878 37.46545116706536, 127.1224034651138 37.46559641185152, 127.1224236952005 37.46585956292014, 127.1222978617648 37.46676441235726, 127.1221821195014 37.46751730536409, 127.121514010366 37.46881876933388, 127.1205378174029 37.47037838206509, 127.1196052885649 37.4716823642653, 127.1187995086813 37.47279633333915, 127.114589692829 37.47852459047009, 127.1116954237647 37.48244033725231, 127.1110900690549 37.48289466254922, 127.1110354206454 37.48293504402488, 127.1110976000359 37.4829408822355, 127.1113897088355 37.48304888033852, 127.111740381725 37.48317960337992, 127.1119777101599 37.48331890553752, 127.1121766422593 37.48343567238243, 127.1122757938946 37.48353852793635, 127.1115628692106 37.484558106389, 127.1101917157413 37.48687888267508, 127.1081396454639 37.48930959967124, 127.1184347733529 37.49251636235878, 127.1210833187137 37.48899787002044)))"
398,서울특별시,송파구,잠실본동,11710650,29680,14041,15639,"MULTIPOLYGON (((127.0866875750158 37.51171743849392, 127.085573370685 37.51142639582591, 127.0858500316779 37.51040405167736, 127.0859396662128 37.51018127957924, 127.0860127578865 37.5100301976014, 127.0860325178723 37.50998949838724, 127.0860576876245 37.50993832630884, 127.0860837293853 37.50989213278203, 127.0861140584248 37.50983833959044, 127.0862255135021 37.50964259253953, 127.0862996034462 37.50953922820894, 127.0863671426762 37.50944556475243, 127.0864236284909 37.50936724514906, 127.0866421395151 37.50911112356993, 127.0868875790391 37.50887742242096, 127.0869286395368 37.50883833706229, 127.0869727771459 37.50880241450173, 127.087226985941 37.50859601301561, 127.0875144508681 37.50840209916582, 127.0879436681841 37.50818235498156, 127.0882618011683 37.50803852844886, 127.0886847793334 37.50789353116757, 127.0888247754164 37.50786043391602, 127.0889665953641 37.50782691019211, 127.0907226274496 37.50753212845004, 127.08362899995 37.49926446356682, 127.075490888551 37.50120046540529, 127.0731813261133 37.50213061115677, 127.0751369315974 37.50353032034288, 127.075194599777 37.5035720714087, 127.0753918641922 37.50371488900488, 127.0761784937936 37.50428669719766, 127.0773165086739 37.50512115225337, 127.0777622789677 37.50544808318583, 127.0777904932641 37.50546877559116, 127.0781090528252 37.5057067234365, 127.0782890078239 37.50584120888206, 127.0785099146175 37.50600706327221, 127.0794742169479 37.50673111893416, 127.079385407826 37.50717011622699, 127.0793765151991 37.50721236281615, 127.0792432478327 37.50780394145654, 127.0783258081586 37.51187030578238, 127.0813266454934 37.51176294038174, 127.0866875750158 37.51171743849392)))"
399,서울특별시,송파구,잠실4동,11710690,22371,10791,11580,"MULTIPOLYGON (((127.1164046623389 37.52396341162023, 127.1127592671797 37.51771922433603, 127.106649113986 37.51551272609658, 127.1033044492623 37.52149805183485, 127.1032126889849 37.52165965358642, 127.1030149334021 37.52200713845937, 127.0981175409782 37.52755870823859, 127.0989571712764 37.52795365256429, 127.1043389265397 37.52422225888794, 127.1061590063532 37.52390148305057, 127.1164046623389 37.52396341162023)))"
400,서울특별시,송파구,잠실6동,11710710,17522,8367,9155,"MULTIPOLYGON (((127.106649113986 37.51551272609658, 127.108090578093 37.51197503871999, 127.1046426890645 37.50924410375093, 127.1040264528227 37.50874929056749, 127.1012746609956 37.51169987545684, 127.0988814906037 37.51487244283858, 127.0986614261093 37.51515787755071, 127.097639453491 37.516480524211, 127.0960818454081 37.51849537679261, 127.0951188985753 37.51974046041587, 127.0942058619805 37.52090571095462, 127.0924010343647 37.52334668134107, 127.0919220569415 37.5239946083636, 127.0904378750911 37.5260022728048, 127.0922507470111 37.5267860261998, 127.0981175409782 37.52755870823859, 127.1030149334021 37.52200713845937, 127.1032126889849 37.52165965358642, 127.1033044492623 37.52149805183485, 127.106649113986 37.51551272609658)))"
401,서울특별시,송파구,잠실7동,11710720,10244,4774,5470,"MULTIPOLYGON (((127.0731813261133 37.50213061115677, 127.0729119603448 37.50231981097726, 127.0726594105102 37.50249721362136, 127.0724885087333 37.50261751264852, 127.071212490393 37.50351614022986, 127.0700194290874 37.50477596008535, 127.0699935703683 37.50480855825788, 127.0698064500091 37.5050444657274, 127.0697125520678 37.50538776693556, 127.0694250446776 37.50644871142377, 127.0688034980296 37.51000278936198, 127.0718812303402 37.51076214906661, 127.0736332599678 37.51117406061875, 127.0783258081586 37.51187030578238, 127.0792432478327 37.50780394145654, 127.0793765151991 37.50721236281615, 127.079385407826 37.50717011622699, 127.0794742169479 37.50673111893416, 127.0785099146175 37.50600706327221, 127.0782890078239 37.50584120888206, 127.0781090528252 37.5057067234365, 127.0777904932641 37.50546877559116, 127.0777622789677 37.50544808318583, 127.0773165086739 37.50512115225337, 127.0761784937936 37.50428669719766, 127.0753918641922 37.50371488900488, 127.075194599777 37.5035720714087, 127.0751369315974 37.50353032034288, 127.0731813261133 37.50213061115677)))"
402,서울특별시,송파구,잠실2동,11710670,36853,17600,19253,"MULTIPOLYGON (((127.0866875750158 37.51171743849392, 127.0813266454934 37.51176294038174, 127.0783258081586 37.51187030578238, 127.0736332599678 37.51117406061875, 127.0718812303402 37.51076214906661, 127.0688034980296 37.51000278936198, 127.0684631425072 37.51028434761371, 127.0684409616945 37.51143462515148, 127.0683814814147 37.51230647185658, 127.0671582574394 37.51998043480461, 127.0664966552108 37.52092972214779, 127.0669618590224 37.52508139275426, 127.0725769188417 37.52377686080059, 127.0728546030312 37.52371250986057, 127.0769469501969 37.52359316911708, 127.0775801807529 37.52357514972427, 127.0798900799743 37.52386618950383, 127.0823646383488 37.5241780488388, 127.083421341676 37.52431134900936, 127.0842850790763 37.52442030365822, 127.0855904208734 37.52474261757749, 127.0875943179362 37.52524537819027, 127.0885196237984 37.52549085969232, 127.0885154124668 37.52402383630869, 127.0885130821308 37.52319574430194, 127.0906623150294 37.51703003997393, 127.0911679552978 37.51559523363094, 127.091937806761 37.51346394765792, 127.0922536034092 37.51261438094406, 127.0925502686689 37.51191349581113, 127.092497896276 37.51190765731009, 127.0916850973427 37.51181922129322, 127.089698344364 37.51160389745973, 127.0887704890054 37.51150379181541, 127.0866875750158 37.51171743849392)))"
403,서울특별시,송파구,잠실3동,11710680,36145,17252,18893,"MULTIPOLYGON (((127.1040264528227 37.50874929056749, 127.1029926976849 37.50804726953614, 127.1026485011417 37.50787710813362, 127.1021420708801 37.50762978291945, 127.1011783787755 37.50719951387946, 127.1006555054085 37.50698705446306, 127.1002857550466 37.50683707857058, 127.0998770541763 37.50669936418885, 127.0994187415312 37.5065806340584, 127.0990825867151 37.50653055878201, 127.0989156513198 37.50650569141455, 127.0987545823686 37.50648825652259, 127.0984619228698 37.50645682853227, 127.098025637433 37.50645309126243, 127.0976733565481 37.50647555262493, 127.0973137318573 37.50653855991121, 127.0907226274496 37.50753212845004, 127.0889665953641 37.50782691019211, 127.0888247754164 37.50786043391602, 127.0886847793334 37.50789353116757, 127.0882618011683 37.50803852844886, 127.0879436681841 37.50818235498156, 127.0875144508681 37.50840209916582, 127.087226985941 37.50859601301561, 127.0869727771459 37.50880241450173, 127.0869286395368 37.50883833706229, 127.0868875790391 37.50887742242096, 127.0866421395151 37.50911112356993, 127.0864236284909 37.50936724514906, 127.0863671426762 37.50944556475243, 127.0862996034462 37.50953922820894, 127.0862255135021 37.50964259253953, 127.0861140584248 37.50983833959044, 127.0860837293853 37.50989213278203, 127.0860576876245 37.50993832630884, 127.0860325178723 37.50998949838724, 127.0860127578865 37.5100301976014, 127.0859396662128 37.51018127957924, 127.0858500316779 37.51040405167736, 127.085573370685 37.51142639582591, 127.0866875750158 37.51171743849392, 127.0887704890054 37.51150379181541, 127.089698344364 37.51160389745973, 127.0916850973427 37.51181922129322, 127.092497896276 37.51190765731009, 127.0925502686689 37.51191349581113, 127.0922536034092 37.51261438094406, 127.091937806761 37.51346394765792, 127.0911679552978 37.51559523363094, 127.0906623150294 37.51703003997393, 127.0885130821308 37.52319574430194, 127.0885154124668 37.52402383630869, 127.0885196237984 37.52549085969232, 127.0904378750911 37.5260022728048, 127.0919220569415 37.5239946083636, 127.0924010343647 37.52334668134107, 127.0942058619805 37.52090571095462, 127.0951188985753 37.51974046041587, 127.0960818454081 37.51849537679261, 127.097639453491 37.516480524211, 127.0986614261093 37.51515787755071, 127.0988814906037 37.51487244283858, 127.1012746609956 37.51169987545684, 127.1040264528227 37.50874929056749)))"
404,서울특별시,송파구,장지동,11710646,34113,16516,17597,"MULTIPOLYGON (((127.1366743717028 37.48915278231174, 127.1353465018538 37.48141507885481, 127.1368430744011 37.4814794956347, 127.1372383313897 37.48158593247577, 127.137689882774 37.4816647118996, 127.1390655464386 37.48170686350312, 127.1385437737523 37.48080808140089, 127.1382993789742 37.4804767921508, 127.1375876363746 37.47987934791443, 127.1371938396623 37.47962772933988, 127.1368516825496 37.47946498413064, 127.1363998816921 37.47932622480649, 127.136265234761 37.47932294763913, 127.1357523939964 37.47918400151936, 127.1351243596603 37.47895907141921, 127.1336776377627 37.47826053474375, 127.1303673511466 37.47579355607112, 127.1268975349013 37.4735054910754, 127.1270298359131 37.47594090987345, 127.1264853652642 37.47753276669958, 127.1257791305052 37.47938847138944, 127.1254051963763 37.48023456928637, 127.1253389067386 37.48038390450736, 127.1250694681803 37.48093206286057, 127.1246853957417 37.48154264459909, 127.1241667447737 37.48236582453692, 127.1263976004645 37.48280772602676, 127.1298092567263 37.48724527987763, 127.1335513819617 37.49053120588665, 127.1379625361625 37.49430226701651, 127.1378431311728 37.4936398986704, 127.1373146623949 37.49309926420012, 127.1372804588158 37.49146706188071, 127.1358956728212 37.49023032752987, 127.1358328593154 37.48952115478401, 127.1366743717028 37.48915278231174)))"
405,서울특별시,송파구,위례동,11710647,28291,13783,14508,"MULTIPOLYGON (((127.1576788696482 37.49016640067002, 127.1572972585322 37.48962864923903, 127.1576386374789 37.48914280054281, 127.1522503471322 37.48624578311514, 127.1519631826255 37.48657877496154, 127.1498397233165 37.48527063558698, 127.1487426681979 37.48398581441308, 127.1477196860279 37.48175024300532, 127.1473995707138 37.47721780909402, 127.1442449481961 37.47732471748754, 127.1441891199086 37.47655940893248, 127.1438984966816 37.47599537181565, 127.1435383695009 37.47524556639735, 127.1434452606241 37.47410418499761, 127.1371532591097 37.47434317850094, 127.1325888929803 37.47484684726042, 127.132371284382 37.47122767565305, 127.1322904089579 37.47028082536919, 127.1318670229806 37.46973417772843, 127.1326762154286 37.46823394934359, 127.130959223056 37.46769926474194, 127.1305644821451 37.46762846921045, 127.1298705556147 37.46790743304485, 127.1287306502901 37.46790874966558, 127.128690191213 37.46792642452985, 127.1286307831999 37.46795237747065, 127.1281972876141 37.46814255469602, 127.1265892914039 37.46885064813597, 127.1268975349013 37.4735054910754, 127.1303673511466 37.47579355607112, 127.1336776377627 37.47826053474375, 127.1351243596603 37.47895907141921, 127.1357523939964 37.47918400151936, 127.136265234761 37.47932294763913, 127.1363998816921 37.47932622480649, 127.1368516825496 37.47946498413064, 127.1371938396623 37.47962772933988, 127.1375876363746 37.47987934791443, 127.1382993789742 37.4804767921508, 127.1385437737523 37.48080808140089, 127.1390655464386 37.48170686350312, 127.137689882774 37.4816647118996, 127.1372383313897 37.48158593247577, 127.1368430744011 37.4814794956347, 127.1353465018538 37.48141507885481, 127.1366743717028 37.48915278231174, 127.1377611922997 37.49043048267845, 127.1414930265991 37.49167965526603, 127.141826699951 37.49165303876617, 127.1420953899187 37.49103998132843, 127.1423784519848 37.4909265825868, 127.1424681896635 37.49049388784355, 127.1424782705806 37.49005203838314, 127.1423744290411 37.48942119858969, 127.1425609555125 37.48917003742154, 127.1427161856682 37.48912145384832, 127.1430374961683 37.4889780572768, 127.1432580468127 37.48876076557162, 127.1443350082142 37.48846481209192, 127.1442129089295 37.48815637720065, 127.1444770660152 37.48773875474257, 127.1445126537227 37.48752623185862, 127.1445789747758 37.48742636736584, 127.1446806781283 37.48740673781204, 127.1450890763888 37.48742611522433, 127.1452743016731 37.48736701832512, 127.1457164209823 37.48709770676256, 127.1459901738039 37.48727313420072, 127.1463054025978 37.48725738596841, 127.1466983492468 37.48733050406805, 127.1468116725731 37.48745231973808, 127.1472023014881 37.48820067980502, 127.147328254217 37.48888213907566, 127.1472996922307 37.48901514289401, 127.1484173022887 37.49005440792038, 127.1496535184337 37.49047712795636, 127.1503570547891 37.49120097103639, 127.1506517386385 37.49143800006475, 127.1504878487159 37.49159523321502, 127.1503284350295 37.49205078383454, 127.1513135622125 37.49267903985675, 127.1524992427851 37.49296708033973, 127.1563857036063 37.49093553727543, 127.1576788696482 37.49016640067002)))"
406,서울특별시,강동구,강일동,11740515,32377,15662,16715,"MULTIPOLYGON (((127.1794756224415 37.56653725292982, 127.1795696693464 37.56570755058582, 127.179574409742 37.5656701753307, 127.1796047544134 37.56556355551925, 127.1796502009526 37.56541144933645, 127.1797593138664 37.56505007744942, 127.1811164901564 37.56244207981366, 127.1815582006505 37.56174922978128, 127.1818246450339 37.56133194537491, 127.1819692544364 37.56094137282262, 127.1819925365781 37.56062370833099, 127.1820211568745 37.56021817619389, 127.1819926770282 37.55959165852429, 127.1819861891639 37.55945182302268, 127.1819842399085 37.55941361839083, 127.1819343620171 37.55915187595023, 127.1818783263964 37.55885787455035, 127.1818476374625 37.55873052877545, 127.181829195156 37.55865396403131, 127.181713532091 37.55817352798223, 127.1816487339233 37.55789433909572, 127.1815842810776 37.55761659325945, 127.1813697809429 37.55314980264274, 127.1813782518536 37.55302158072221, 127.1813894443864 37.55285240857274, 127.1828256101531 37.54656368634357, 127.183365652247 37.54601530853509, 127.1835519034555 37.54582646715932, 127.1809090165415 37.54588134835599, 127.1806123167978 37.54609802989577, 127.1801311374204 37.54644374945491, 127.179766480915 37.54651036276925, 127.1792535798253 37.54660366802655, 127.1790463564459 37.5466413585008, 127.1788426713159 37.54657964679525, 127.1776317263699 37.54621274099343, 127.1768928344137 37.54585580987533, 127.1755905992147 37.54521453185278, 127.174652424008 37.54521634116792, 127.1743870972975 37.54521685369691, 127.1742451347777 37.5453223714741, 127.174127199701 37.54541112977806, 127.173641051598 37.54691384894046, 127.1731291672527 37.54911037044618, 127.1731033692641 37.54922158035791, 127.1730505126516 37.54944953098862, 127.1724870550325 37.55225231041942, 127.1719134245205 37.55510913964877, 127.1718511528712 37.55543232748062, 127.1715964047289 37.55675465310064, 127.1715318089915 37.55709105797031, 127.1714869115216 37.55732415752265, 127.1710322925057 37.55932840413676, 127.1704929897368 37.5623993880745, 127.1701393041156 37.5628857891574, 127.1688252001367 37.56379069225236, 127.1671209729503 37.56492611083873, 127.1659990712837 37.56655551722186, 127.165204872502 37.56880655836927, 127.1650281553522 37.56906641265114, 127.1673130328575 37.57091163175343, 127.1674170570666 37.57099529990516, 127.1655148058522 37.57369230391387, 127.1653543633158 37.57391916552501, 127.161570227432 37.57780416641499, 127.1647144814186 37.57952120099164, 127.1660604969051 37.57958472729398, 127.1686326245726 37.5793035434037, 127.1719200334436 37.57941976116664, 127.1739529456599 37.57958200336486, 127.1750105456555 37.58005249545342, 127.1769365448174 37.58071011944042, 127.1776672592538 37.58083494134746, 127.1773797067816 37.58021673060397, 127.1769730800842 37.57945501374762, 127.1755097533566 37.57837960964092, 127.1754603403427 37.57802231348318, 127.1754039929369 37.57761111545103, 127.1753594908595 37.57728630839028, 127.1758174076579 37.57484715817318, 127.1759193844574 37.57460734517159, 127.1760591048959 37.57427884350547, 127.1761390011707 37.57413484646591, 127.1778229877636 37.57146919947034, 127.1791136513095 37.56914778925791, 127.1792329044618 37.56881742965425, 127.1792426508806 37.5687627710801, 127.1792553909195 37.56869130140024, 127.1793997585548 37.56786695593976, 127.1794220639474 37.56773802393418, 127.1794527412506 37.567560639906, 127.1794756224415 37.56653725292982)))"
407,서울특별시,강동구,상일동,11740520,10943,5455,5488,"MULTIPOLYGON (((127.174127199701 37.54541112977806, 127.1739746901364 37.54552555506177, 127.168599025733 37.54518948423944, 127.164109873749 37.54486470555747, 127.1631930474553 37.5450186856869, 127.1627940214791 37.54563041555215, 127.1625132067454 37.54590571564383, 127.1610638646501 37.54571485941901, 127.159687001607 37.54553369190416, 127.1590105624681 37.54554525989502, 127.1559396383387 37.54622363545257, 127.1563206908684 37.55168244857236, 127.1565026228321 37.55428566302676, 127.1565594705672 37.55509692359977, 127.156578964798 37.55537537070118, 127.1618021262801 37.55610364633065, 127.1640190441101 37.55643220966826, 127.1652043363853 37.55660798398654, 127.1669044745946 37.5568076878864, 127.1714869115216 37.55732415752265, 127.1715318089915 37.55709105797031, 127.1715964047289 37.55675465310064, 127.1718511528712 37.55543232748062, 127.1719134245205 37.55510913964877, 127.1724870550325 37.55225231041942, 127.1730505126516 37.54944953098862, 127.1731033692641 37.54922158035791, 127.1731291672527 37.54911037044618, 127.173641051598 37.54691384894046, 127.174127199701 37.54541112977806)))"
408,서울특별시,강동구,명일1동,11740530,26212,12845,13367,"MULTIPOLYGON (((127.1502116001885 37.55469305983627, 127.1496687883069 37.55122236355096, 127.1485685498263 37.54577930934905, 127.1475975829674 37.54599172230953, 127.1463458548624 37.54526802252202, 127.1456353311692 37.5448557757154, 127.1456844897559 37.54467506628014, 127.1457152612718 37.54456194837427, 127.145761463794 37.54436161833716, 127.1427328981842 37.54507118339207, 127.1429442399091 37.54517568489451, 127.1433082229334 37.54620382594646, 127.1439508261591 37.55078838347839, 127.1412042902865 37.55086941811655, 127.1409435954598 37.55089705617601, 127.140668466362 37.55092603601632, 127.1405658230646 37.55099329362771, 127.1405392792359 37.55101127145536, 127.1404284977761 37.5511063965775, 127.1403758062432 37.55115176801547, 127.1403596701058 37.55119725979085, 127.1403162549196 37.55132063200286, 127.1431903561001 37.55461233501757, 127.1444717848577 37.55477055824149, 127.1502116001885 37.55469305983627)))"
409,서울특별시,강동구,명일2동,11740540,18000,8870,9130,"MULTIPOLYGON (((127.1631930474553 37.5450186856869, 127.1604021051552 37.54159780430568, 127.1597465638879 37.54239151094038, 127.1593382405828 37.54272383540975, 127.1591701508874 37.5428157393583, 127.1568229727046 37.54338002689939, 127.1536213743989 37.54325365146502, 127.14871093513 37.54514889247083, 127.1485685498263 37.54577930934905, 127.1496687883069 37.55122236355096, 127.1502116001885 37.55469305983627, 127.156578964798 37.55537537070118, 127.1565594705672 37.55509692359977, 127.1565026228321 37.55428566302676, 127.1563206908684 37.55168244857236, 127.1559396383387 37.54622363545257, 127.1590105624681 37.54554525989502, 127.159687001607 37.54553369190416, 127.1610638646501 37.54571485941901, 127.1625132067454 37.54590571564383, 127.1627940214791 37.54563041555215, 127.1631930474553 37.5450186856869)))"
410,서울특별시,강동구,고덕1동,11740550,27334,13876,13458,"MULTIPOLYGON (((127.156578964798 37.55537537070118, 127.1502116001885 37.55469305983627, 127.1444717848577 37.55477055824149, 127.1445020802486 37.55509739019968, 127.1446041402301 37.55625481019627, 127.1440747628142 37.55864852157738, 127.1454674620859 37.55998224729075, 127.1459436874628 37.56043660623442, 127.1472532792737 37.56139934035598, 127.1452305284543 37.5654764063252, 127.1423900752077 37.56909925964775, 127.1413314016227 37.5702767174464, 127.1471897420642 37.57171963247233, 127.1529940686039 37.57373336277401, 127.153322670337 37.56752766804797, 127.154354466487 37.56804528430635, 127.1547225395176 37.56818607092828, 127.1553154721983 37.56821822419583, 127.155439291127 37.56817040837221, 127.1559351324808 37.56797892008249, 127.1563633363659 37.56735823429568, 127.156927030999 37.56296240195029, 127.1568401092775 37.56062088395522, 127.1568381884844 37.56057581161342, 127.1567371089986 37.55854521933108, 127.1566055742649 37.55590612384161, 127.156578964798 37.55537537070118)))"
411,서울특별시,강동구,고덕2동,11740560,7419,3944,3475,"MULTIPOLYGON (((127.1714869115216 37.55732415752265, 127.1669044745946 37.5568076878864, 127.1652043363853 37.55660798398654, 127.1640190441101 37.55643220966826, 127.1618021262801 37.55610364633065, 127.156578964798 37.55537537070118, 127.1566055742649 37.55590612384161, 127.1567371089986 37.55854521933108, 127.1568381884844 37.56057581161342, 127.1568401092775 37.56062088395522, 127.156927030999 37.56296240195029, 127.1563633363659 37.56735823429568, 127.1559351324808 37.56797892008249, 127.155439291127 37.56817040837221, 127.1553154721983 37.56821822419583, 127.1547225395176 37.56818607092828, 127.154354466487 37.56804528430635, 127.153322670337 37.56752766804797, 127.1529940686039 37.57373336277401, 127.161570227432 37.57780416641499, 127.1653543633158 37.57391916552501, 127.1655148058522 37.57369230391387, 127.1674170570666 37.57099529990516, 127.1673130328575 37.57091163175343, 127.1650281553522 37.56906641265114, 127.165204872502 37.56880655836927, 127.1659990712837 37.56655551722186, 127.1671209729503 37.56492611083873, 127.1688252001367 37.56379069225236, 127.1701393041156 37.5628857891574, 127.1704929897368 37.5623993880745, 127.1710322925057 37.55932840413676, 127.1714869115216 37.55732415752265)))"
412,서울특별시,강동구,암사2동,11740580,14557,7083,7474,"MULTIPOLYGON (((127.1291955315113 37.55476172114027, 127.127665338259 37.5500692308976, 127.1267373861032 37.54789257637394, 127.1257123924664 37.54812819068907, 127.1253752124354 37.54820598991093, 127.1229575597939 37.54876389449392, 127.1229073981899 37.54877609187433, 127.1231200206613 37.54938071401057, 127.1231527866383 37.54947224292938, 127.1124444759977 37.54950727503481, 127.1130704327739 37.5513311889072, 127.1133429826299 37.55199663159392, 127.1133570809716 37.55203104636526, 127.1138893953175 37.55333036745829, 127.1138921667855 37.55512365449116, 127.1138942621246 37.5566619551125, 127.1138968924526 37.55859879907216, 127.1137691771839 37.55888549092251, 127.1134843899741 37.56025063398706, 127.1139287267367 37.56016195708469, 127.1144080260933 37.56006629454764, 127.1149940479747 37.5599490121711, 127.1154826512994 37.5598512213691, 127.1165079846544 37.55999606762728, 127.1166825970843 37.56002073681968, 127.116824267329 37.56017066793046, 127.1175835901972 37.56097459507694, 127.1193555103727 37.5626579626086, 127.1207658690507 37.56350639110798, 127.121746500119 37.56399442009304, 127.1222809615841 37.56425454788099, 127.1223641547215 37.56428329763243, 127.1313759030825 37.56745411661412, 127.1314620833868 37.56748705966456, 127.1317354478695 37.56759269391415, 127.1318343396696 37.56763131069204, 127.1320660232015 37.5677230505481, 127.1322774634185 37.5678073006628, 127.1327716551799 37.56800716419228, 127.1329807203868 37.5680934427134, 127.1332222750151 37.56819334207785, 127.1338246819846 37.56844520191191, 127.1334514327182 37.56504608209481, 127.1334399041805 37.56494239082737, 127.1323307553355 37.56152394379227, 127.1322478108569 37.56140988971517, 127.1311003374632 37.55975570807132, 127.1310401024459 37.55962933047416, 127.1306076970579 37.5586319836017, 127.1301517615178 37.55738781591346, 127.1299877589928 37.55693919439704, 127.129819426681 37.55647866118655, 127.1294982831591 37.55559770781043, 127.1291955315113 37.55476172114027)))"
413,서울특별시,강동구,암사3동,11740590,18821,9226,9595,"MULTIPOLYGON (((127.1444717848577 37.55477055824149, 127.1299533369631 37.55475783870058, 127.1291955315113 37.55476172114027, 127.1294982831591 37.55559770781043, 127.129819426681 37.55647866118655, 127.1299877589928 37.55693919439704, 127.1301517615178 37.55738781591346, 127.1306076970579 37.5586319836017, 127.1310401024459 37.55962933047416, 127.1311003374632 37.55975570807132, 127.1322478108569 37.56140988971517, 127.1323307553355 37.56152394379227, 127.1334399041805 37.56494239082737, 127.1334514327182 37.56504608209481, 127.1338246819846 37.56844520191191, 127.1413314016227 37.5702767174464, 127.1423900752077 37.56909925964775, 127.1452305284543 37.5654764063252, 127.1472532792737 37.56139934035598, 127.1459436874628 37.56043660623442, 127.1454674620859 37.55998224729075, 127.1440747628142 37.55864852157738, 127.1446041402301 37.55625481019627, 127.1445020802486 37.55509739019968, 127.1444717848577 37.55477055824149)))"
414,서울특별시,강동구,천호1동,11740600,28623,14090,14533,"MULTIPOLYGON (((127.1427328981842 37.54507118339207, 127.141687015242 37.54227725036389, 127.1410021061976 37.54243854081885, 127.1380732796699 37.54313153094344, 127.1336074944464 37.54242371621967, 127.133466585735 37.5424143464942, 127.1331406963912 37.54239409866577, 127.1328107215787 37.54237368580669, 127.1327623119925 37.54237144862793, 127.1323526980412 37.54236460817259, 127.1311455848039 37.54239239120035, 127.1345778328947 37.54712046995204, 127.1351348603825 37.54781629414833, 127.1357466981086 37.54842218084598, 127.1365770662439 37.54922460145369, 127.1373113418586 37.54991526856574, 127.1379446918345 37.55026199023143, 127.1387420111716 37.55041160547314, 127.1391535440595 37.55048876599712, 127.1412042902865 37.55086941811655, 127.1439508261591 37.55078838347839, 127.1433082229334 37.54620382594646, 127.1429442399091 37.54517568489451, 127.1427328981842 37.54507118339207)))"
415,서울특별시,강동구,천호3동,11740620,28294,13947,14347,"MULTIPOLYGON (((127.141687015242 37.54227725036389, 127.1396877806057 37.5410746174045, 127.1379144117157 37.54116383543512, 127.1377730545125 37.54113523454492, 127.1373913987944 37.54105632128149, 127.1370840520854 37.54082665810095, 127.1368094545554 37.54042924617642, 127.1367055968752 37.54023510636678, 127.1363123156344 37.53949140390581, 127.1343875335862 37.53547068743141, 127.1329470889113 37.53591947513383, 127.1299378714483 37.53666050769302, 127.1264233896787 37.53766011994201, 127.1274247686166 37.53900513380131, 127.128672777453 37.54056503174471, 127.1287632475381 37.54058221571037, 127.1290870639277 37.54067861380867, 127.1293446346542 37.54075529957238, 127.1297695133514 37.54096169081592, 127.1298096885311 37.54099336421101, 127.1301021398429 37.54122525300271, 127.1303479516835 37.54142084260987, 127.1305241281828 37.54158936877309, 127.1308566897951 37.54200953911471, 127.1311455848039 37.54239239120035, 127.1323526980412 37.54236460817259, 127.1327623119925 37.54237144862793, 127.1328107215787 37.54237368580669, 127.1331406963912 37.54239409866577, 127.133466585735 37.5424143464942, 127.1336074944464 37.54242371621967, 127.1380732796699 37.54313153094344, 127.1410021061976 37.54243854081885, 127.141687015242 37.54227725036389)))"
416,서울특별시,강동구,성내1동,11740640,20648,10001,10647,"MULTIPOLYGON (((127.1318226871469 37.53014171036793, 127.1287418613178 37.52379095793577, 127.1191613156011 37.52806564603419, 127.1207198282461 37.53131725019986, 127.1212608373923 37.53310755020215, 127.1255897544475 37.53186558025955, 127.1260580649669 37.53261019843422, 127.1261667365897 37.53271979773159, 127.1263058223452 37.53285998246249, 127.1264221648289 37.53295512820442, 127.1264969152193 37.53301045105427, 127.1265931038883 37.53289438558389, 127.1266234507545 37.53285760703316, 127.127261442402 37.53201335209213, 127.1272266731618 37.53190069442861, 127.1270531734592 37.53146633891609, 127.127674723061 37.53127791731284, 127.1285127581063 37.53103493664231, 127.1297969954541 37.53068124418098, 127.1305648351509 37.53047013967862, 127.1318226871469 37.53014171036793)))"
417,서울특별시,강동구,성내2동,11740650,25300,12529,12771,"MULTIPOLYGON (((127.1264233896787 37.53766011994201, 127.1299378714483 37.53666050769302, 127.1329470889113 37.53591947513383, 127.1343875335862 37.53547068743141, 127.1342912233693 37.53527131652618, 127.1318226871469 37.53014171036793, 127.1305648351509 37.53047013967862, 127.1297969954541 37.53068124418098, 127.1285127581063 37.53103493664231, 127.127674723061 37.53127791731284, 127.1270531734592 37.53146633891609, 127.1272266731618 37.53190069442861, 127.127261442402 37.53201335209213, 127.1266234507545 37.53285760703316, 127.1265931038883 37.53289438558389, 127.1264969152193 37.53301045105427, 127.1264221648289 37.53295512820442, 127.1263058223452 37.53285998246249, 127.1261667365897 37.53271979773159, 127.1260580649669 37.53261019843422, 127.1255897544475 37.53186558025955, 127.1212608373923 37.53310755020215, 127.122432618233 37.53626492893626, 127.1232114342576 37.53852869389421, 127.1240760987351 37.53822701852168, 127.1264233896787 37.53766011994201)))"
418,서울특별시,강동구,성내3동,11740660,23991,11882,12109,"MULTIPOLYGON (((127.138572270693 37.53398769652081, 127.1368950944316 37.52951845166837, 127.1366329021694 37.52882596153754, 127.1339083832697 37.52154020710932, 127.1287418613178 37.52379095793577, 127.1318226871469 37.53014171036793, 127.1342912233693 37.53527131652618, 127.138572270693 37.53398769652081)))"
419,서울특별시,강동구,둔촌1동,11740690,287,136,151,"MULTIPOLYGON (((127.1458000886755 37.52198996684139, 127.1456398734295 37.52161992912742, 127.1452414971768 37.52065795668804, 127.1450783342458 37.52026395116312, 127.1447315398553 37.51941675765426, 127.144837843237 37.51803011075185, 127.144875956214 37.51776979557509, 127.1449072739449 37.51755597910744, 127.1450092397392 37.516933220845, 127.1446130522717 37.51696019781758, 127.1432054507867 37.51744381494846, 127.1408303468887 37.51850585380578, 127.1394184346398 37.51913813670537, 127.1339083832697 37.52154020710932, 127.1366329021694 37.52882596153754, 127.1433895285531 37.52691427009739, 127.1447289169715 37.52653523593466, 127.1449464048816 37.52616520013228, 127.1457547418214 37.52469954016024, 127.1460087969469 37.52422370862799, 127.1461139264206 37.52398065688569, 127.146162476323 37.52358533128356, 127.1461479009781 37.52307714669262, 127.1460489075116 37.52262053722325, 127.1458000886755 37.52198996684139)))"
420,서울특별시,강동구,둔촌2동,11740700,27943,13811,14132,"MULTIPOLYGON (((127.1535524222539 37.53399651907954, 127.1535718449345 37.5310209690097, 127.153514907483 37.53033013664761, 127.153264858145 37.5293312211051, 127.1531124919722 37.52909184171362, 127.1526558792061 37.52855869845862, 127.1524319824133 37.52833382694194, 127.1522164181771 37.5281427804597, 127.1519381008117 37.52790986084283, 127.1508191988532 37.52697139892112, 127.1498004427149 37.52610195097196, 127.1496587132687 37.52595959373836, 127.1495821940614 37.5258827242293, 127.1494277587387 37.52563097171408, 127.1490562875127 37.5246001070355, 127.1489720393298 37.52436169971708, 127.1489522703039 37.52430572968821, 127.1489768783742 37.5241863728208, 127.1485406181267 37.52324991582164, 127.1485177819718 37.52320136377932, 127.1484376651585 37.52303102992276, 127.1477634611043 37.52216933126086, 127.1474215640489 37.52206692716931, 127.1465284719603 37.5220180630589, 127.1463508991379 37.52201121296008, 127.1458000886755 37.52198996684139, 127.1460489075116 37.52262053722325, 127.1461479009781 37.52307714669262, 127.146162476323 37.52358533128356, 127.1461139264206 37.52398065688569, 127.1460087969469 37.52422370862799, 127.1457547418214 37.52469954016024, 127.1449464048816 37.52616520013228, 127.1447289169715 37.52653523593466, 127.1433895285531 37.52691427009739, 127.1366329021694 37.52882596153754, 127.1368950944316 37.52951845166837, 127.138572270693 37.53398769652081, 127.1393101210968 37.53385134806489, 127.1397531636478 37.53380880431803, 127.1399806919921 37.53378695523836, 127.140486374398 37.53373888508126, 127.1407056243608 37.5337485659066, 127.1407891698757 37.53375256068963, 127.1409319429581 37.53375939451361, 127.1414871119598 37.53381855623159, 127.1417577716106 37.53384753147724, 127.1427204069476 37.53415687392725, 127.1430531775622 37.53426382390194, 127.1447957816013 37.53498007208257, 127.1451776096271 37.53514341549134, 127.1498294719874 37.53714141332834, 127.1586674287132 37.54088538519898, 127.1589401388057 37.54099739240773, 127.1604021051552 37.54159780430568, 127.1596602044669 37.54099979440402, 127.1586771601018 37.54014865459171, 127.1575632535193 37.53903460613312, 127.1569937590082 37.53836687877954, 127.1570029229779 37.53817019242803, 127.1570086717203 37.53804694049264, 127.1569872205749 37.53794096877886, 127.1568705911939 37.53776486539963, 127.1567313812551 37.53757630170929, 127.1545569041097 37.53492560606342, 127.1544062723306 37.53476179347282, 127.153852254811 37.53417203625578, 127.1535524222539 37.53399651907954)))"
421,서울특별시,강동구,암사1동,11740570,36975,18329,18646,"MULTIPOLYGON (((127.1444717848577 37.55477055824149, 127.1431903561001 37.55461233501757, 127.1403162549196 37.55132063200286, 127.1403596701058 37.55119725979085, 127.1403758062432 37.55115176801547, 127.1404284977761 37.5511063965775, 127.1405392792359 37.55101127145536, 127.1405658230646 37.55099329362771, 127.140668466362 37.55092603601632, 127.1409435954598 37.55089705617601, 127.1412042902865 37.55086941811655, 127.1391535440595 37.55048876599712, 127.1387420111716 37.55041160547314, 127.1379446918345 37.55026199023143, 127.1373113418586 37.54991526856574, 127.1365770662439 37.54922460145369, 127.1357466981086 37.54842218084598, 127.1351348603825 37.54781629414833, 127.1345778328947 37.54712046995204, 127.1279384607158 37.54995258319624, 127.127665338259 37.5500692308976, 127.1291955315113 37.55476172114027, 127.1299533369631 37.55475783870058, 127.1444717848577 37.55477055824149)))"
422,서울특별시,강동구,천호2동,11740610,36078,18023,18055,"MULTIPOLYGON (((127.1345778328947 37.54712046995204, 127.1311455848039 37.54239239120035, 127.1308566897951 37.54200953911471, 127.1305241281828 37.54158936877309, 127.1303479516835 37.54142084260987, 127.1301021398429 37.54122525300271, 127.1298096885311 37.54099336421101, 127.1297695133514 37.54096169081592, 127.1293446346542 37.54075529957238, 127.1290870639277 37.54067861380867, 127.1287632475381 37.54058221571037, 127.128672777453 37.54056503174471, 127.1274247686166 37.53900513380131, 127.1264233896787 37.53766011994201, 127.1240760987351 37.53822701852168, 127.1232114342576 37.53852869389421, 127.1216101192163 37.53915677511969, 127.1214793216588 37.53923118647219, 127.1214171353589 37.53926657264082, 127.1204649646042 37.53981108966332, 127.1197948184326 37.54027286152222, 127.1195985474329 37.54040807268806, 127.1195150545117 37.54046489554321, 127.1190836812091 37.54070687076531, 127.1185978805054 37.54089328033719, 127.1185002979239 37.54093032629324, 127.1184317992535 37.54095105247117, 127.1183897613333 37.54096376995346, 127.1171171858497 37.54134497994282, 127.1095643777354 37.54346998109902, 127.1108865233861 37.5454748474335, 127.1115685106824 37.54650964728895, 127.1120718602993 37.54754560584924, 127.1122233080118 37.54834157252363, 127.1124444759977 37.54950727503481, 127.1231527866383 37.54947224292938, 127.1231200206613 37.54938071401057, 127.1229073981899 37.54877609187433, 127.1229575597939 37.54876389449392, 127.1253752124354 37.54820598991093, 127.1257123924664 37.54812819068907, 127.1267373861032 37.54789257637394, 127.127665338259 37.5500692308976, 127.1279384607158 37.54995258319624, 127.1345778328947 37.54712046995204)))"
423,서울특별시,강동구,길동,11740685,46720,22881,23839,"MULTIPOLYGON (((127.1485685498263 37.54577930934905, 127.14871093513 37.54514889247083, 127.1536213743989 37.54325365146502, 127.1568229727046 37.54338002689939, 127.1591701508874 37.5428157393583, 127.1593382405828 37.54272383540975, 127.1597465638879 37.54239151094038, 127.1604021051552 37.54159780430568, 127.1589401388057 37.54099739240773, 127.1586674287132 37.54088538519898, 127.1498294719874 37.53714141332834, 127.1451776096271 37.53514341549134, 127.1447957816013 37.53498007208257, 127.1430531775622 37.53426382390194, 127.1427204069476 37.53415687392725, 127.1417577716106 37.53384753147724, 127.1414871119598 37.53381855623159, 127.1409319429581 37.53375939451361, 127.1407891698757 37.53375256068963, 127.1407056243608 37.5337485659066, 127.140486374398 37.53373888508126, 127.1399806919921 37.53378695523836, 127.1397531636478 37.53380880431803, 127.1393101210968 37.53385134806489, 127.138572270693 37.53398769652081, 127.1342912233693 37.53527131652618, 127.1343875335862 37.53547068743141, 127.1363123156344 37.53949140390581, 127.1367055968752 37.54023510636678, 127.1368094545554 37.54042924617642, 127.1370840520854 37.54082665810095, 127.1373913987944 37.54105632128149, 127.1377730545125 37.54113523454492, 127.1379144117157 37.54116383543512, 127.1396877806057 37.5410746174045, 127.141687015242 37.54227725036389, 127.1427328981842 37.54507118339207, 127.145761463794 37.54436161833716, 127.1457152612718 37.54456194837427, 127.1456844897559 37.54467506628014, 127.1456353311692 37.5448557757154, 127.1463458548624 37.54526802252202, 127.1475975829674 37.54599172230953, 127.1485685498263 37.54577930934905)))"
